border_size=1
usage=map

Gg, Gg, Gg, Gg, Qyw, Qyw, Gg, Gg, Gg^Es, Gg, Gg, Mm, Mm, Mm, Mm, Mm, Gg, Gg, Gg, Gg, Gg, Gg, Gg, Gs^Fds, Gs^Fds, Gs^Fds, Gs^Fds, Gs^Fds, Gs^Fds
Gg, Rb^Em, Chr^Es, Rb, Qyw, Qyw, Qyw, Gg, Gg, Gg, Gg^Es, Mm, Mm, Mm, Mm, Mm, Gg, Gg^Es, Gll^Fp, Gll^Fp, Gll^Fp, Gg, Gg, Gs^Fds, Gs^Fds, Gs^Fds, Gll^Fp, Gs^Fds, Gs^Fds
Rb, Khr, Urb, Rp^Dr, Gg, Qyw, Qyw, Rb^Es, Gg, Gg^Efm, Gg, Hh^Fp, Mm, Mm, Mm, Hh^Fp, Gg, Gs^Fds, Gs^Fds, Gs^Fms, Gll^Fp, Gd^Em, Gll^Fp, Gg^Es, Gll^Fp, Gs^Fds, Gs^Fms, Gs^Fds, Gs^Fds
Re, Chr^Dr, Rp, Rb, Gg^Bsb\, Qyw, Qyw, Qyw, Chr^Dr, Gg, Gg, Gg, Gg^Es, Mm, Gg^Es, Gg, Gs^Fds, Gll^Fp, Gg^Fet, Gll^Fp, Gs^Fds, Gs^Fds, Gll^Fp, Gg, Gg^Em, Gs^Fds, Gll^Fp, Gs^Fds, Gs^Fds
Gg, Re^Dr, Chr^Dr, Gg, Gg^Es, Qyw^Bsb\, Qyw^Bsb\, Qyw, 2 Re^Es, Gg^Efm, Gg, Gg, Gg, Gg^Imb, Re, Gs^Fds, Gll^Fp, Gs^Fds, Gs^Fds, Gs^Fds, Re^Cov, Gs^Fds, Gd, Gg, Gs^Fds, Gs^Fds, Gs^Fds, Gs^Fds, Gs^Fds
Gg, Rb, Re, Rb, Qyw, Qyw, Qyw, Qyw^Bsb\, Rp, Gg, Rb, Re, Re, Rp, Gg, Rb, Rd^Es, Rb, Re, Re^Cov, Rp^Kov, Re^Cov, Re, Gs^Fds, Rb, Gs^Fds, Re, 1 Rb, Re
Gg, Gg, Gg, Gg, Qyw, Qyw, Chr^Es, Rb^Es, Gg, Re, Gg, Gll^Fp, Hh^Fp, Gg^Imb, Gg^Es, Gg, Gs^Fds, Gs^Fds, Gll^Fp, Rb^Cov, Re^Cov, Re^Cov, Gll^Fp, Re, Gs^Fms, Rb^Es, Gs^Fds, Gs^Fds, Gs^Fds
Gg, Gd^Es, Gg, Qyw, Qyw, Qyw, Gg, Gg, Gg, Gg, Mm, Hh^Fp, Mm, Mm, Mm, Gg^Em, Gs^Fds, Gll^Fp, Wwr, Gll^Fp, Gll^Fp, Gs^Fds, Gll^Fp, Gs^Fds, Gs^Fds, Gs^Fds, Gs^Fds, Gll^Fp, Gs^Fds
Gg, Gg, Gg, Qyw, Qyw, Qyw, Gg, Gg^Efm, Gg, Mm, Mm, Mm, Mm, Mm, Mm, Hh^Fp, Gll^Fp, Ww^Ewl, Wo, Ww^Ewl, Gg^Fet, Gll^Fp, Gs^Fds, Gs^Fds, Gs^Fds, Gll^Fp, Gs^Fds, Gs^Fds, Gs^Fds
Gg, Gg^Efm, Gg, Rb^Es, Qyw, Qyw, Qyw, Gg, Gg^Es, Mm, Mm, Mm, Hh^Fp, Mm, Gg^Es, Gg^Em, Ww^Ewf, Ww, Wo, Ww, Ww, Gd^Es, Gll^Fp, Gll^Fp, Gs^Fds, Gs^Fds, Gs^Fds, Gs^Fds, Gs^Fds
Gg, Gg, Gg, Qyw, Qyw, Qyw, Qyw, Gg^Es, Hh^Fp, Mm, Mm, Mm, Hh^Fp, Gg, Gll^Fp, Gll^Fp, Ww, Wo, Wo, Wo, Ww, Wwr, Gll^Fp, Gll^Fp, Gs^Fds, Gs^Fds, Gg^Fet, Gs^Fds, Gs^Fds
Gg, Gg, Gg, Gg, Qyw, Qyw, Re^Es, Gg, Hh^Fp, Mm, Mm, Mm, Hh^Fp, Gll^Fp, Gs^Fds, Gll^Fp, Gll^Fp, Ww, Ww, Ww, Ww, Gll^Fp, Gs^Fds, Gs^Fds, Gs^Fds, Gs^Fds, Gs^Fds, Gs^Fds, Gs^Fds
Gg, Gg, Gg, Gg, Qyw, Qyw, Gg, Gg, Gg, Mm, Mm, Mm, Gg, Gll^Fp, Gll^Fp, Gll^Fp, Gll^Fp, Gll^Fp, Gg, Gll^Fp, Gg, Gll^Fp, Gg, Gs^Fds, Gs^Fds, Gs^Fds, Gg, Gs^Fds, Gs^Fds
