border_size=1
usage=map

Gg, Gg, Gg, Gg, Gg, Gg, Sm, Sm, Ss, Ss, Ss, Gg, Sm, Gll^Fp, Gll^Fp, Gg, Gs^Fds, Gs^Fds, Gs^Fds, Gg, Gd^Es, Gg, Gg, Gg, Gg^Gvs, Gg^Gvs, Gg^Gvs, Gg^Gvs, Gg^Gvs, Gg, Gg^Gvs, Hh^Fds, Hh^Fds, Mm, Mm, Mm, Mm^Xm, Mm, Mm^Xm, Mm^Xm, Mm^Xm, Mm^Xm, Wo
Gg, Gg, Re, Re, Re, Sm, Ss, Ss, Wwg, Ss, Ss, Ss, Sm^Em, Sm, Sm, Gll^Fp, Rb, Gs^Fds, Gg, Gg, Gg, Gg, Gg^Gvs, Gg^Gvs, Gg^Gvs, Gg^Gvs, Gg^Gvs, Gg^Gvs, Gg^Gvs, Gg^Gvs, Gg, Gg, Hh^Fds, Hh^Fds, Hh^Fds, Mm, Mm, Mm^Xm, Wo, Wo, Wo, Wo, Mm^Xm
Gg, Gg, Re, Rp, Re, Sm, Ss, Ww^Ewl, Wwg, Ss, Rb^Es, Ss, Ss, Ss, Ss, Sm, Rb^Es, Gg, Gg, Gg, Gs^Fds, Gg, Gg, Gg^Gvs, Gg^Gvs, Gg^Gvs, Gg^Gvs, Gg^Gvs, Gg, Gg, Gs^Fds, Gg^Es, Gg, Hh^Fds, Gg, Hh^Fds, Hh^Fds, Hh, Wo, Hh, Hh, Mm^Xm, Mm^Xm
Gll^Fp, Gll^Fp, Gll^Fp, Re^Es, Sm, Sm^Em, Ss, Ss, Ss, Ss, Wwrg, Wwf, Ss, Ss, Ss, Sm^Em, Rb, Gg, Gll^Em, Gs^Fds, Gs^Fds, Gg, Gd^Es, Gg, Gg, Gg^Fet, Gg, Gg, Gg^Es, Gg^Em, Gg, Gg, Gg, Gg, Ww, Gg, Wo, Wo, 1 Hh^Fds, Hh, Mm, Mm, Mm^Xm
Gg, Gll^Fp, Sm, Sm, Ss, Ss, Rb^Es, Ss^Vhs, Wwf, Rb, Ss, Wwf, Ss, Rb^Es, Ss, Sm, Gll^Fp, Gd, Gg, Gll^Fp, Gg, Gg, Gg, Gg, Gg, Gs^Vh, Re, Re, Re^Es, Gg, Re, Rd^Es, Re, Ww, Wo, Wo, Ww, Re, Gg, Hh^Fds, Mm, Mm^Xm, Mm^Xm
Gg, Rb, Sm, Ss, Ss, Sm, Ss, Wwf, Wwg, Ss, Gd^Fetd, Ss, Sm, Ss, Sm, Sm, Gll^Fp, Gg, Gg, Gg, Gg, Gg, Re, Gg, Ww^Ewl, Rp, Ww^Bsb\, Ww^Ewl, Wo, Wo, Wo, Ww, Wo, Wo, Ww, Ww, Re^Es, Rb, Gg, Hh^Fds, Mm, Mm^Xm, Mm^Xm
Gg, Rb, Rb^Es, Sm, Sm^Em, Ss, Ss, Wwf, Wwg, Wwf, Ss, Ss, Ss, Sm^Em, Sm, Gll^Fp, Gll^Fp, Gg, Re, Gs^Vh, Ww^Ewl, Rb^Es, Wo, Rb, Ww, Ww^Ewl, Wo, Ww^Bsb\, Rp, Ww, Gg, Wo, Re, Ss, Re, Gg^Em, Gg, Gg, Hh^Fds, Hh^Fds, Mm, Mm, Mm
Gg, Gll^Fp, Gll^Fp, Sm, Ss, Ss, Ss, Re, Ss, Ss, Sm^Em, Ss, Ss, Ss, Sm, Rb, Gd, Re, Chw, Ww, Wo, Wo, Ww, Wo, Wo, Wo, Ww^Bw\, Re, Rp, Rr, Ce, Ce, Ket, Re, Gg, Gg, Gg, Gg, Hh^Fds, Hh^Fds, Mm, Mm, Mm
Gll^Fp, Gll^Fp, Rb^Es, Sm, Sm, Ss, Wwf, Ss, Ss, Ww^Ewl, Sm, Ss, Sm^Em, Sm, Gg^Es, Gg, Gg, Rb^Es, Wo, Wo, Gg, Ww, Ww^Ewf, Ww, Ss, Ww^Bw\, Re^Es, Re, Rr^Vhc, Rp, Rd, Rr, Rr, Rp, Ket, Gg, Gg, Gg, Gg^Es, Hh^Fds, Mm, Mm, Mm
Gll^Fp, Gll^Fp, Gll^Fp, Gg, Ss^Vhs, Sm^Em, Ww^Ewl, Ss, Wwf, Ss, Ss, Ss, Wwf, Sm, Wwg, Rb, Ww^Bw\, Ww, Wo, Ww, Gg, Re, Re^Es, Rb, Gg, Re, Re, 2 Ket, Rr^Vhc, Rr, Rr^Vhc, Rp, Rr^Vhc, Rr, Ce, Re^Es, Gg, Gd, Gg^Es, Hh^Fds, Mm, Mm, Mm
Gg, Gll^Fp, Gg, Rd, Wwg^Bw\, Wwg, Wog, Wwg, Wwg, Wwg, Wwg, Wwf, Wwg, Wwg, Wog, Ww, Wo, Ww^Bw\, Re, Ce^Es, Gg, Gd, Gg, Gg, Gs^Fds, Gg, Re^Es, Ce^Es, Rr^Vhc, Rd, Rp, Rd, Rr^Vhc, Rr^Vhc, Ce^Es, Rb, Gg, Gg, Hh^Fds, Hh^Fds, Mm, Mm, Mm
Gg, Gg, Gg, Wwg, Wog, Wog^Bw\, Rp, Sm, Ss, Ww^Ewf, Ss, Wwg, Sm, Wwg, Sm, Wo, Rb, Ce^Es, Gg, Rb, Re, Gg, Gg, Gg^Em, Gs^Fds, Gs^Fds, Gg, Ce, Ket, Rr, Re, Rr, Ket, Ce, Re^Es, Gg, Gg, Gg, Gg, Hh^Fds, Mm, Mm, Mm
Gg, Ss, Wwf, Wog, Ce^Es, Re, Gg, Gg, Hh^Fp, Ss, Hh^Fp, Sm, Hh^Fp, Sm, Hh^Fp, Rb, Rb^Es, Gg, Gg, Gd, Gg, Re, Rb, Gll, Rb, Gg, Gg, Re, Gg, Re^Es, Rp, Rb^Es, Gg, Rb, Gs^Fds, Gs^Fds, Gs^Fds, Gg, Gd, Hh^Fds, Mm, Mm, Mm
Ww, Wwf, Wwg, Wwg, Re, Gg, Gll, Gg, Gg, Hh^Fp, Hh^Fp, Hh^Fp, Hh^Fp, Hh^Fp, Hh^Fp, Hh, Hh^Fp, Hh, Gg, Gg, Gg^Es, Gg, Gg^Em, Re, Gg^Fet, Re, Rb, Gg, Re, Gd, Re, Gg, Gd^Es, Gg, Gg^Em, Gs^Fms, Gg, Gg, Hh^Fds, Hh^Fds, Mm, Mm, Mm
Wog, Wwg, Ss, Ss, Gg, Gg, Gg, Gg, Gg, Gg, Re^Dr, Hh^Fp, Hh^Fp, Hh^Fp, Hh^Fp, Hh^Fp, Hh^Fp, Hh, Re^Es, Gg, Gg, Gg, Gll, Gd, Gll, Gg, Gg, Re, Gg^Es, Re, Gg, Gg, Gg, Gg, Gg, Gg, Hh^Fds, Hh^Fds, Hh^Fds, Hh^Fds, Mm, Mm, Mm
Wwg, Gg, Gg, Gg, Gg, Gll, Gg, Gg, Hh^Fp, Hh^Fp, Hh, Hh^Fp, Hh^Fp, Chr^Dr, Hh^Dr, Hh, Hh, Hh, Hh, Gg, Gs^Fds, Gs^Fds, Gg, Gll, Gs^Fds, Gll^Fp, Gll^Fp, Gg^Es, Gg, Gg^Es, Gg, Gg, Hh^Fds, Hh^Fds, Hh^Fds, Hh^Fds, Hh^Fds, Hh^Fds, Mm, Mm, Mm, Mm, Mm
Gg, Gg, Gd, Gg, Gg, Gg, Gll^Fp, Re, Hh^Fp, Hh^Fp, Hh^Fp, Hh^Fp, Hh^Fp, Hh^Dr, Hh^Fp, Hh, Hh^Fp, Hh^Fp, Hh, Rb^Es, Gg, Gs^Fds, Gg^Es, Gg, Gll^Fp, Gll^Fp, Gll^Fp, Gs^Fms, Gs^Fms, Gs^Fds, Gs^Fds, Gg, Hh^Fds, Hh^Fds, Hh^Fds, Hh^Fds, Mm, Mm, Mm, Mm, Mm, Mm, Mm
Gg, Gg, Gd, Gd, Gg, Gg, Gll^Fp, Gll^Fp, Hh^Fp, Hh, Gll^Fp, Hh, Gll^Fp, Gd^Fetd, Hh^Fp, Hh^Fp, Hh^Fp, Hh, Re^Es, Gg, Gg, Gd, Gg, Gg, Gg^Em, Gs^Fds, Gll^Fp, Gs^Fds, Gs^Fms, Gll^Fp, Gs^Fds, Hh^Fds, Hh^Fds, Hh^Fds, Mm, Mm, Mm, Mm, Mm, Mm, Mm, Mm, Mm
Gg, Gg, Gg, Gg, Gg, Gg, Gg, Gll^Fp, Gg, Gll^Fp, Gll^Fp, Gll^Fp, Gll^Fp, Gll^Fp, Gg, Hh, Gg, Hh, Gg, Gg, Gg, Gg, Gg, Gg, Gg, Gs^Fds, Gg, Gs^Fds, Gg, Gll^Fp, Hh^Fds, Hh^Fds, Mm, Mm, Mm, Mm, Mm, Mm, Mm, Mm, Mm, Mm, Mm
