border_size=1
usage=map

Gll^Fp, Gll^Fp, Gs^Fds, Gll^Fp, Gll^Fp, Gll^Fp, Gll^Fp, Hh^Fp, Gs^Fds, Gll^Fp, Gll^Fp, Gll^Fp, Gll^Fp, Gll^Fp, Uh, Gll^Fp, Gll^Fp, Gll^Fp, Uh, Gll^Fp, Gll^Fp, Gll^Fp, Gll^Fp, Gll^Fp, Gs^Fds, Gll^Fp, Gs^Fds, Gll^Fp, Gll^Fp, Gll^Fp, Gll^Fp, Gll^Fp, Gll^Fp
Gll^Fp, Gs^Fds, Gs^Fds, Gll^Fp, Gll^Fp, Gll^Fp, Gll^Fp, Gs^Fds, Gs^Fms, Gll^Fp, Gll^Fp, Gll^Fp, Uh, Uh, Xuc, Uh, Uh, Uh, Xuc, Uh, Uh, Gll^Fp, Gll^Fp, Gll^Fp, Gll^Fp, Gll^Fp, Gs^Fds, Gs^Fds, Gg, Gll^Fp, Gs^Fds, Gs^Fds, Gs^Fds
Gs^Fds, Gs^Fms, Gll^Fp, Gg^Fet, Gll^Fp, Gll^Fp, Gll^Fp, Gll^Fp, Gll^Fp, Gs^Fms, Gll^Fp, Uh, Xuc, Xuc, Uh, Xuc, Xuc, Xuc, Uh, Xuc, Xuc, Uh, Gll^Fp, Gs^Fds, Gll^Fp, Gs^Fms, Gll^Fp, Gs^Fds, Gll^Fp, Gll^Fp, Gg^Fet, Gll^Fp, Gll^Fp
Gll^Fp, Gs^Fds, Gll^Fp, Gll^Fp, Gll^Fp, Gll^Fp, Re^V26, Gll^Fp, Gll^Fp, Gg, Gll^Fp, Uh, Xuc, Uh, Wwg, Uh, 2 Urb^Kov, Uh, Wwg, Uh, Xuc, Uh, Gll^Fp, Gll^Fp, Gs^Fds, Gll^Fp, Gs^Fds, Gll^Fp, Gll^Fp, Gll^Fp, Gll^Fp, Gs^Fds, Gs^Fds
Gll^Fp, Gs^Fds, Gg, Gs^Fms, Gs^Fds, Gll^Fp, Rb^Es, Rp, Gll^Fp, Gll^Fp, Gll^Fp, Uh, Xuc, Uu, Uu, Urb^Cov, Uh^Ecfy, Urb^Cov, Uu, Uu, Xuc, Uh^Dr, Gll^Fp, Gll^Fp, Gg^Fet, Gll^Fp, Gll^Fp, Gs^Emf, Re^V25, Gll^Fp, Gll^Fp, Gs^Fms, Gll^Fp
Gll^Fp, Gll^Fp, Gll^Fp, Gs^Fms, Gll^Fp, Gs^Fds, Rp, Gll^Fp, Gll^Fp, Gll^Fp, Gll^Fp, Uh, Uh^Dr, Xuc, Urb, Uu^Cov, Urb^Cov, Uu^Cov, Urb, Xuc, Uh^Dr, Uh, Gs^Fds, Gll^Fp, Gll^Fp, Gs^Fms, Gg^Em, Gs^Fds, Rd, Rp, Gll^Fp, Gll^Fp, Gll^Fp
Gll^Fp, Gll^Fp, Gll^Fp, Gs^Fds, Gll^Fp, Gs^Fds, Rp, Gll^Fp, Gll^Fp, Gll^Fp, Gll^Fp, Gll^Fp, Gll^Fp, Rb^Es, Xuc, Uu^Es, Xuc, Uu^Es, Xuc, Rb^Es, Gll^Fp, Gll^Fp, Gs^Fds, Gs^Fds, Gll^Fp, Gll^Fp, Gg, Gg^Efm, Gg, Gll^Fp, Gll^Fp, Gll^Fp, Gll^Fp
Gll^Fp, Gll^Fp, Gll^Fp, Gll^Fp, Re, Rp, Gll^Fp, Gll^Fp, Gs^Fds, Gs^Fds, Gll^Fp, Gll^Fp, Gll^Fp, Re^Es, Rb, Rb, Re^Es, Rb, Re, Rb^Es, Gll^Fp, Gll^Fp, Gll^Fp, Gll^Fp, Gg, Gll^Fp, Gs^Fds, Gg, Gg^Em, Gd^Es, Gs^Fds, Gll^Fp, Gll^Fp
Gll^Fp, Gll^Fp, Gll^Fp, Gll^Fp, Re^V25, Gll^Fp, Gll^Fp, Gll^Fp, Gll^Fp, Gs^Fms, Gll^Fp, Gll^Fp, Gll^Fp, Gll^Fp, Gll^Fp, Gll^Fp, Rb, Gll^Fp, Gll^Fp, Gll^Fp, Gll^Fp, Gll^Fp, Gll^Fp, Gll^Fp, Gll^Fp, Gs^Fds, Gs^Fds, Gll^Fp, Rd, Gll^Fp, Gll^Fp, Gll^Fp, Gll^Fp
Gs^Fds, Gll^Fp, Gll^Fp, Gll^Dr, Rp, Gll^Fp, Gll^Fp, Gll^Fp, Gs^Fms, Gg, Gll^Fp, Gs^Fds, Gll^Fp, Gll^Fp, Gll^Fp, Gll^Fp, Re^Es, Gll^Fp, Gs^Fds, Gll^Fp, Gs^Fds, Gll^Fp, Gll^Fp, Gll^Fp, Gll^Fp, Gll^Fp, Gg^Fet, Gll^Fp, Re^Es, Gs^Fds, Gs^Fds, Gll^Fp, Gll^Fp
Gs^Fds, Gs^Fds, Gll^Fp, Gll^Fp, Re, Gll^Fp, Gll^Fp, Gll^Fp, Gll^Fp, Gs^Fds, Gll^Fp, Gll^Fp, Gll^Fp, Gll^Fp, Ss, Gll^Fp, Sm, Gll^Fp, Gll^Fp, Gs^Fds, Gs^Fms, Gll^Fp, Gll^Dr, Re^V26, Rp, Gll^Fp, Gll^Fp, Gs^Fms, Rp, Gll^Fp, Gs^Fds, Gs^Fms, Gll^Fp
Gs^Fds, Gs^Fds, Gll^Fp, Rp, Gs^Fds, Gs^Fds, Gll^Fp, Gll^Fp, Gll^Fp, Gll^Fp, Rb^Es, Re^Es, Rb, Rb^Fdyu, Ss, Sm^Em, Wwg, Rb^Fdyu, Gs^Fds, Gll^Fp, Gll^Fp, Gll^Fp, Gs^Fms, Gll^Fp, Gll^Fp, Re, Rb^Es, Re, Gll^Fp, Gll^Fp, Gll^Fp, Gll^Fp, Gll^Fp
Gll^Fp, Gll^Fp, Gll^Fp, Re, Gll^Fp, Gs^Fds, Gs^Fds, Gs^Fds, Gll^Fp, Gll^Fp, Gs, Ss, Sm, Gs^Fds, Ss, Ww^Ewl, Wwf, Ss, Rb^Fdyu, Gll^Fp, Re^Es, Gll^Fp, Gll^Fp, Gll^Fp, Gll^Fp, Gll^Fp, Gs^Fds, Rp, Re, Gll^Fp, Gll^Fp, Gll^Fp, Gll^Fp
Gll^Fp, Gll^Fp, Gll^Fp, Gd, Rp, Gll^Fp, Gs^Fds, Gs^Fms, Gll^Fp, Gll^Fp, Ss, Ss, Sm^Em, Rb, Gll^Fp, Ss, Rb^Fdyu, Sm^Es, Gs^Fdw, Rb, Sm, Gd^Fetd, Gg, Gll^Fp, Gll^Fp, Gll^Fp, Gll^Fp, Gs^Fds, Gll^Fp, Rp, Gll^Fp, Gll^Fp, Gll^Fp
Gll^Fp, Gll^Fp, Gs^Fds, Gll^Fp, Gll^Fp, Re^Es, Gll^Fp, Gs^Fms, Gll^Fp, Rb, Sm, Wwf, Gll^Fdw, Ss, Rb^Fdyu, Re, 3 Gd^FYok, Re^Es, Gs^Fds, Rb^Fdyu, Wwg, Ss, Ss, Gd^Fmw, Gll^Fp, Gll^Fp, Gs^Fds, Gll^Fp, Re, Rp, Gll^Fp, Gll^Fp, Gll^Fp
Gll^Fp, Gll^Fp, Gs^Fms, Gs^Fds, Gll^Fp, Gll^Fp, Gll^Fp, Gll^Fp, Gll^Fp, Rb^Fdyu, Gd^Fetd, Wwg, Gll^Fp, Rb^Fdyu, Gll^Fp, Rb^Fdyu, Rb, Rb^Fdyu, Gll^Fp, Ss, Wwf, Sm^Es, Sm^Em, Gll^Fp, Gs^Fds, Gll^Fp, Gll^Fp, Gll^Fp, Rb^Es, Gll^Fp, Gll^Fp, Gll^Fp, Gll^Fp
Gll^Fp, Gll^Fp, Gll^Fp, Gll^Fp, Gll^Fp, Gll^Fp, Gg, Gll^Fp, Gll^Fp, Gll^Fp, Gll^Fp, Re, Rb^Es, Sm^Em, Ww^Ewl, Ss, Rb^Fdyu, Gs^Fdw, Rb^Fdyu, Ss, Ss, Sm, Gll^Fp, Gll^Fp, Gll^Fp, Gll^Fp, Gg, Gll^Fp, Gll^Fp, Gll, Rp, Gll^Fp, Gll^Fp
Gll^Fp, Gll^Fp, Gll^Fp, Gll^Fp, Gll^Fp, Gll^Fp, Gll^Fp, Gll^Fp, Gs^Fds, Gs^Fds, Gll^Fp, Gll^Fp, Gs^Fds, Sm^Es, Ss, Wwf, Sm, Gll^Fp, Rb^Fdyu, Gll^Fp, Gd^Fetd, Gll^Fp, Gll^Fp, Gll^Fp, Gll^Fp, Gs^Fms, Gs^Fms, Gll^Fp, Gll^Fp, Gll^Fp, Rp^Es, Gll^Fp, Gll^Fp
Gll^Fp, Gll^Fp, Gll^Fp, Gll^Fp, Gs^Fds, Gs^Fds, Gs^Fds, Gll^Fp, Gll^Fp, Gs^Fds, Gll^Fp, Gll^Fp, Gll^Fp, Gs^Fdw, Gs^Fds, Gs^Fdw, Rb^Es, Gs^Fds, Gll^Fp, Gll^Fp, Gll^Fp, Gll^Fp, Gll^Fp, Gll^Fp, Gll^Fp, Gll^Fp, Gs^Fds, Gll^Fp, Rp, Re, Gll^Fp, Gs^Fds, Gs^Fds
Gll^Fp, Gll^Fp, Gll^Fp, Gll^Fp, Gd^Es, Rb^Em, Gg^Dr, Gll^Fp, Gll^Fp, Gll^Fp, Gll^Fp, Gll^Es, Gll^Fp, Gll^Fp, Gll^Fp, Gll^Fp, Gll^Fp, Gll^Fp, Gll^Fp, Gll^Fp, Gll^Fp, Gs^Fms, Rp, Re^V25, Rp, Gs^Fds, Gs^Fds, Gll^Fp, Re^Es, Gll^Fp, Gg^Fet, Gs^Fds, Gll^Fp
Gll^Fp, Gs^Fds, Gs^Fds, Gs^Fds, Gll^Em, Gll^Imc, Gg^Emf, Gs^Fds, Gll^Fp, Gll^Fp, Gll^Fp, Gll^Fp, Gll^Fp, Gll^Fp, Gll^Fp, Gll^Fp, Gll^Fp, Gll^Fp, Re, Gll^Fp, Gll^Fp, Gll^Fp, Rb^Es, Gll^Fp, Gll^Fp, Rd, Re^Es, Gll^Fp, Rp, Gll^Fp, Gll^Fp, Gll^Fp, Gll^Fp
Gs^Fds, Gs^Fms, Gs^Fms, Gll^Fp, Gll^Fp, Re^Es, Gs^Fds, Gll^Fp, Gll^Fp, Gll^Fp, Gll^Fp, Gll^Fp, Gll^Fp, Gs^Fds, Gs^Fds, Re^V26, Rr, Re^Es, Gll^Fp, Rp, Rp, Rp, Gll^Fp, Gll^Fp, Gll^Fp, Gll^Fp, Gll^Fp, Rp, Gll^Fp, Gll^Fp, Gll^Fp, Gll^Fp, Gll^Fp
Gs^Fds, Gll^Fp, Gll^Fp, Gll^Fp, Gs^Fds, Gll^Fp, Gll^Fp, Gs^Fds, Gs^Fds, Gll^Fp, Gll^Fp, Gll^Fp, Gll^Fp, Gll^Fp, Gs^Fds, Gs^Fms, Gll^Fp, Gll^Fp, Gll^Fp, Gll^Fp, Gs^Fms, Gs^Fds, Gs^Fds, Gs^Fds, Gll^Fp, Gll^Fp, Gs^Fms, Gll^Fp, Gll^Fp, Gll^Fp, Gll^Fp, Gll^Fp, Gll^Fp
Gs^Fds, Gs^Fds, Gll^Fp, Gll^Fp, Gll^Fp, Gll^Fp, Gll^Fp, Gll^Fp, Gll^Fp, Gll^Fp, Gll^Fp, Gg^Fet, Gll^Fp, Gs^Fds, Gll^Fp, Gll^Fp, Gll^Fp, Gll^Fp, Gll^Fp, Gs^Fms, Gs^Fds, Gll^Fp, Gll^Fp, Gg, Gll^Fp, Gll^Fp, Gll^Fp, Gll^Fp, Re^V26, Gll^Fp, Gll^Fp, Gll^Fp, Gll^Fp
Gs^Fds, Gll^Fp, Gll^Fp, Gll^Fp, Gll^Fp, Gg, Gll^Fp, Gll^Fp, Gll^Fp, Gll^Fp, Gll^Fp, Gll^Fp, Gll^Fp, Gll^Fp, Rd^Es, Re, Rd^Es, Re, Rb, Gll^Fp, Gll^Fp, Gll^Fp, Gll^Fp, Gll^Fp, Gll^Fp, Gll^Fp, Gll^Fp, Gll^Em, Gs^Fds, Rp, Gll^Fp, Gll^Fp, Gll^Fp
Gll^Fp, Gll^Fp, Gs^Fds, Gs^Fds, Gs^Fds, Gll^Fp, Re^Es, Gll^Fp, Gs^Fds, Gll^Fp, Gs^Fms, Gll^Fp, Gll^Fp, Gs^Fds, Re^Em, Ke, 1 Ke, Ke, Re, Gll^Fp, Gs^Fms, Gll^Fp, Gll^Fp, Gll^Fp, Gg^Fet, Gll^Fp, Gll^Fp, Gll^Fp, Gs^Fds, Gs^Fds, Gll^Fp, Gll^Fp, Gll^Fp
Gll^Fp, Gll^Fp, Gs^Fds, Gg^Fet, Gs^Fds, Re^V26, Rp, Gll^Fp, Gll^Fp, Gs^Fms, Gll^Fp, Gs^Fds, Gll^Fp, Gll^Fp, Gll^Fp, Rb^Cov, Re^Cov, Re^Cov, Gll^Fp, Gll^Fp, Gll^Fp, Gll^Fp, Gs^Fms, Gs^Fds, Gs^Fms, Gll^Fp, Gll^Fp, Gs^Fms, Gs^Fms, Gll^Fp, Gd^Fetd, Gll^Fp, Gll^Fp
Gs^Fds, Gll^Fp, Gll^Fp, Gll^Fp, Gll^Fp, Gll^Fp, Gll^Fp, Gll^Fp, Gll^Fp, Gs^Fds, Gs^Fds, Gs^Fds, Gll^Fp, Gll^Fp, Gs^Fms, Gll^Fp, Re, Gs^Fds, Gs^Fds, Gs^Fds, Gll^Fp, Gll^Fp, Gs^Fds, Gll^Fp, Gs^Fds, Gll^Fp, Gll^Fp, Gg, Gll^Fp, Gll^Fp, Gll^Fp, Gll^Fp, Gll^Fp
Gs^Fds, Gll^Fp, Gll^Fp, Gll^Fp, Gll^Fp, Gll^Fp, Gll^Fp, Gs^Fds, Gll^Fp, Gll^Fp, Gs^Fds, Gll^Fp, Gll^Fp, Gll^Fp, Gll^Fp, Gll^Fp, Re, Gll^Fp, Gll^Fp, Gs^Fds, Gll^Fp, Gll^Fp, Gll^Fp, Gs^Fds, Gll^Fp, Gll^Fp, Gll^Fp, Gll^Fp, Gll^Fp, Gll^Fp, Gll^Fp, Gll^Fp, Gll^Fp
