border_size=1
usage=map

Mm^Xm, Mm, Wwt, Mm^Xm, Mm^Xm, Mm^Xm, Mm^Xm, Mm, Mm^Xm, Mm^Xm, Mm^Xm, Mm, Mm^Xm, Mm^Xm, Mm^Xm, Mm, Mm^Xm, Mm^Xm, Mm^Xm, Mm^Xm, Mm^Xm, Mm, Mm^Xm, Mm^Xm, Mm^Xm, Mm^Xm, Mm^Xm, Mm^Xm, Mm^Xm, Mm^Xm, Mm^Xm, Mm^Xm, Mm^Xm, Mm^Xm, Mm^Xm, Mm^Xm, Mm^Xm, Mm^Xm, Mm^Xm, Mm^Xm, Mm^Xm, Mm^Xm, Mm^Xm, Mm^Xm, Mm^Xm, Mm^Xm, Mm^Xm, Mm^Xm, Mm^Xm, Mm^Xm, Mm, Mm, Wwt
Mm^Xm, Mm^Xm, Wwt, Mm^Xm, Mm^Xm, Mm^Xm, Mm^Xm, Mm^Xm, Mm^Xm, Mm^Xm, Mm^Xm, Mm^Xm, Mm^Xm, Mm^Xm, Mm^Xm, Mm^Xm, Mm^Xm, Mm^Xm, Mm^Xm, Mm^Xm, Mm, Mm, Mm, Mm^Xm, Mm, Mm, Mm, Mm^Xm, Mm^Xm, Mm^Xm, Mm, Mm^Xm, Mm, Mm^Xm, Mm, Mm^Xm, Mm^Xm, Mm^Xm, Mm^Xm, Mm^Xm, Mm^Xm, Mm^Xm, Mm^Xm, Mm^Xm, Mm^Xm, Mm^Xm, Mm^Xm, Mm^Xm, Mm^Xm, Mm^Xm, Wwt, Wwt, Mm
Mm^Xm, Mm^Xm, Mm^Xm, Wwt, Wwt, Mm^Xm, Mm^Xm, Mm^Xm, Mm, Mm^Xm, Mm^Xm, Mm^Xm, Mm^Xm, Mm^Xm, Mm^Xm, Mm^Xm, Mm^Xm, Mm^Xm, Mm, Mm, Hh, Mm, Hh, Mm, Hh, Hh, Hh, Mm, Hh, Mm, Hh^Dr, Mm, Hh, Mm, Hh, Mm, Mm^Xm, Mm^Xm, Mm^Xm, Mm^Xm, Mm^Xm, Mm^Xm, Mm^Xm, Mm^Xm, Mm^Xm, Mm^Xm, Mm^Xm, Mm^Xm, Mm^Xm, Mm^Xm, Wwt, Mm^Xm, Mm
Mm^Xm, Mm^Xm, Mm^Xm, Mm^Xm, Wwt, Mm, Mm, Mm, Wwt, Mm, Mm, Mm^Xm, Mm^Xm, Mm^Xm, Mm^Xm, Mm^Xm, Mm, Mm, Hh, Hh, Hh^Dr, Hh, Gll^Fdf, Gll^Fdf, Gll^Fdw, Gll^Fdw, Gll^Fdw, Hh, Gll^Fdw, Hh, Gll^Fdw, Hh, Rb^Fdyu, Hh, Gll^Fdf, Mm, Mm, Mm^Xm, Mm^Xm, Mm^Xm, Mm^Xm, Mm^Xm, Mm^Xm, Mm^Xm, Mm^Xm, Mm^Xm, Mm^Xm, Mm, Wwt, Wwt, Mm, Mm, Mm^Xm
Mm, Mm, Mm^Xm, Mm, Mm, Wwt, Wwt, Wwt, Mm, Wwt, Wwt, Mm, Mm, Mm^Xm, Mm, Mm, Mm, Mm, Rb^Fdyu, Gll^Fdf, Gll^Fdw, Gll^Fdf, Rb^Fdyu, Rb^Fdyu, Gll^Fdf, Gll^Fdf, Gll^Fdf, Rb^Fdyu, Rb^Es, Gll^Fdw, Gll^Fdw, Rb^Es, Gd^FYok, Re^Dr, Gll^Fdf, Gll^Fdf, Hh, Mm, Mm, Mm^Xm, Mm^Xm, Mm^Xm, Mm^Xm, Mm^Xm, Mm, Mm^Xm, Mm, Mm, Wwt, Mm, Mm^Xm, Mm^Xm, Mm^Xm
Mm^Xm, Mm^Xm, Mm^Xm, Mm^Xm, Mm^Xm, Mm, Mm, Mm, Mm^Xm, Mm, Wwt, Mm, Mm, Mm, Hh, Hh, Gll^Fdf, Gll^Fdw, Rb^Fdyu, Gll^Fdf, Gll^Fdf, Gll^Fdf, Gll^Fdf, Rb^Fdyu, Gd^Fetd, Gll^Fdf, Gll^Fdf, Gll^Fdw, Gll^Fdw, Gll^Fdw, Gll^Fdf, Re, Rb^Es, Gll^Fdf, Gd^Es, Gll^Fdf, Gll^Fdw, Hh, Mm, Mm, Mm, Mm^Xm, Mm, Mm, Wwrt, Mm, Mm, Wwt, Mm, Mm, Mm^Xm, Mm^Xm, Mm^Xm
Mm^Xm, Mm^Xm, Mm^Xm, Mm^Xm, Mm, Mm^Xm, Mm^Xm, Mm^Xm, Mm^Xm, Mm, Wwt, Mm, Hh, Hh, Gll^Fdf, Gll^Fdf, Gd^Fetd, Gll^Fdw, Gll^Fdf, Gll^Fdf, Rb^Fdyu, Gll^Fdw, Gll^Fdf, Rb^Es, Gs, Re^Es, Gll^Fdw, Gll^Fdw, Rb^Fdyu, Rb^Fdyu, Gll^Fdf, Gll^Fdf, Gll^Fdf, Gll^Fdf, Gll^Fdf, Gll^Fdf, Gd^Fetd, Rb^Fdyu, Gll^Fdf, Hh, Rb^Fdyu, Mm, Wwt, Wwrt, Mm, Wwrt, Wwt, Wwt, Mm, Mm^Xm, Mm^Xm, Mm^Xm, Mm
Mm^Xm, Mm^Xm, Mm, Mm^Xm, Mm^Xm, Mm^Xm, Mm, Mm^Xm, Mm, Mm, Hh, Wwt, Wwt, Gll^Fdw, Gll^Fdw, Gll^Fdf, Gd^Es, Gd^Es, Gs^Fds, Gll^Fdf, 1 Gs^Fds, Gs^Fds, Gs^Fds, Gs^Fds, Gs^Fds, Gs^Fds, Gs^Fds, Gs^Fds, Gs^Fds, Gs^Fds, Gs^Fds, Gll^Fdf, Gs^Fds, Gs^Fds, Gs^Fds, Gs^Fds, Gs^Fds, Gll^Fdf, Gll^Fdf, Gd^Es, Gll^Fdf, Gll^Fdf, Wwt, Mm, Mm, Mm, Mm, Mm, Mm^Xm, Mm^Xm, Mm^Xm, Mm^Xm, Mm^Xm
Mm^Xm, Mm^Xm, Mm^Xm, Mm^Xm, Mm, Mm, Mm, Mm, Hh, Hh, Gll^Fdf, Re^Es, Wwt, Gll^Fdw, Gd^Es, Gll^Fdw, Gs^Fds, Gs^Fds, Gs^Fds, Gs^Fds, Gs^Fds, Gs^Fds, Gs^Fds, Gs^Fds, Gs^Fds, Gs^Fds, Gs^Fds, Gs^Fds, Gs^Fds, Gs^Fds, Gs^Fds, Gs^Fds, Gs^Fds, Gs^Fds, Gs^Fds, Gs^Fds, Gs^Fds, Gs^Fds, Gs^Fds, Gll^Fdw, Wwt, Wwt, Gll^Fdf, Gll^Fdf, Gll^Dr, Mm, Mm, Mm, Mm^Xm, Mm^Xm, Mm^Xm, Mm^Xm, Mm^Xm
Mm^Xm, Mm^Xm, Mm, Mm, Mm, Mm, Hh, Gll^Fdf, Gll^Fdf, Gll^Fdf, Gll^Fdf, Gll^Fdf, Wwt, Wwt, Gs^Fds, Gs^Fds, Gs^Fds, Gs^Fds, Gs^Fds, Gs^Fds, Gs^Fds, Gs^Fds, Gs^Fds, Gs^Fds, Gs^Fds, Gs^Fds, Gs^Fds, Gs^Fds, Gs^Fds, Gs^Fds, Gs^Fds, Gs^Fds, Gs^Fds, Gs^Fds, Gs^Fds, Gs^Fds, Gs^Fds, Gs^Fds, Gs^Fds, Wwt, Gs^Fds, Gll^Fdf, Gll^Fdf, Gs, Gs^Es, Hh, Hh, Mm, Mm, Mm^Xm, Mm^Xm, Mm^Xm, Mm^Xm
Mm^Xm, Mm^Xm, Mm, Mm, Hh^Dr, Gll^Fdf, Rd^Es, Gll^Fdf, Gs^Fds, Gs^Fds, Gs^Fds, Gs^Fds, Wwt, Gs^Fds, Gs^Fds, Gs^Fds, Gs^Fds, Gs^Fds, Gs^Fds, Gs^Fds, Gs^Fds, Gs^Fds, Gs^Fds, Gs^Fds, Gg^Fet, Gg^Fet, Gg^Fet, Gs^Fds, Gs^Fds, Gs^Fds, Gs^Fds, Gs^Fds, Gs^Fds, Gs^Fds, Gs^Fds, Gs^Fds, Gs^Fds, Gs^Fds, Gs^Fds, Wwt, Gs^Fds, Gll^Fdf, Gll^Fdf, Gd^Fetd, Gll^Fdf, Rb^Fdyu, Hh, Hh, Hh, Mm, Mm, Mm^Xm, Mm^Xm
Mm^Xm, Mm, Mm, Hh, Gd^Fetd, Gll^Fdf, Rb^Fdyu, Gll^Fdf, Gs^Fds, Gs^Fds, Gs^Fds, Wwt, Gs^Fds, Gs^Fds, Gs^Fds, Gs^Fds, Gs^Fds, Gg^Fet, Gs^Fds, Gs^Fds, Gs^Fds, Gs^Fds, Gs^Fds, Gs^Fds, Gs^Fds, Gg^Fet, Gs^Fds, Gs^Fds, Gs^Fds, Gs^Fds, Gg^Fet, Gg^Fet, Gs^Fds, Gs^Fds, Gs^Fds, Gs^Fds, Gs^Fds, Gs^Fds, Gs^Fds, Wwt, Wwt, Gs^Fds, Gs^Fds, Gll^Fdf, Gll^Fdf, Gll^Fdf, Gd, Gll^Fdf, Gll^Fdw, Hh, Hh^Dr, Mm, Mm^Xm
Mm^Xm, Mm^Xm, Mm, Hh, Gll^Fdw, Gll^Fdw, Gll^Fdf, Gs^Fds, Gs^Fds, Gs^Fds, Gs^Fds, Wwt, Wwrt, Gs^Fds, Gs^Fds, Gs^Fds, Gs^Fds, Gs^Fds, Gs^Fds, Gs^Fds, Gs^Fds, Gs^Fds, Gs^Fds, Gs^Fds, Gs^Fds, Gs^Fds, Gs^Fds, Gs^Fds, Gs^Fds, Gs^Fds, Gg^Fet, Gs^Fds, Gs^Fds, Gs^Fds, Gs^Fds, Gs^Fds, Gs^Fds, Gs^Fds, Gs^Fds, Gs^Fds, Gs^Fds, Wwt, Wwrt, Gs^Fds, Gs^Fds, Gll^Fdf, Gd^Es, Re, Gll^Fdf, Hh, Mm, Mm^Xm, Mm^Xm
Mm^Xm, Mm^Xm, Mm, Hh, Gd^Es, Gll^Fdf, Gll^Fdf, Gs^Fds, Gs^Fds, Gs^Fds, Gs^Fds, Gs^Fds, Gs^Fds, Wwrt, Gs^Fds, Gs^Fds, Gs^Fds, Gs^Fds, Gs^Fds, Gs^Fds, Gs^Fds, Gs^Fds, Gs^Fds, Gs^Fds, Gs^Fds, Gs^Fds, Gs^Fds, Gs^Fds, Gs^Fds, Gg^Fet, Gs^Fds, Gs^Fds, Gs^Fds, Gs^Fds, Gs^Fds, Gs^Fds, Gs^Fds, Gg^Fet, Gg^Fet, Gs^Fds, Gs^Fds, Gs^Fds, Gs^Fds, Wwrt, Wwt, Gs^Fds, Gll^Fdf, Gs, Rb^Fdyu, Hh, Hh, Mm, Mm^Xm
Mm^Xm, Hh, Hh, Re^Es, Gd, Rb^Fdyu, Gll^Fdf, Gll^Fdf, Gs^Fds, Gs^Fds, Gs^Fds, Gs^Fds, Gs^Fds, Wwt, Wwt, Gs^Emf, Gs^Fds, Gs^Fds, Gs^Fds, Gs^Fds, Gg^Fet, Gg^Fet, Gg^Fet, Gs^Fds, Gs^Fds, Gs^Fds, Gs^Fds, Gs^Fds, Gs^Fds, Gs^Fds, Gs^Fds, Gs^Fds, Gs^Fds, Gs^Fds, Gs^Fds, Gs^Fds, Gs^Fds, Gs^Fds, Gs^Fds, Gs^Fds, Gs^Fds, Gs^Fds, Gs^Fds, Gs^Fds, Wwt, Gs^Fds, Gs^Fds, Gll^Fdf, Gll^Fdw, Hh, Mm, Mm, Mm^Xm
Mm^Xm, Mm, Hh, Hh, Gll^Fdw, Gll^Fdf, Re, Rb^Fdyu, Gd^FYok, Gs^Fds, Gs^Fds, Gs^Fds, Gg^Fet, Gs^Fds, Gg^Efm, Wwt, Gs^Fds, Gs^Fds, Gs^Fds, Gs^Fds, Gs^Fds, Gs^Fds, Gs^Fds, Gs^Fds, Gs^Fds, Gs^Fds, Gs^Fds, Gs^Fds, Gg^Fet, Gs^Fds, Gs^Fds, Gs^Fds, Gg^Fet, Gs^Fds, Gs^Fds, Gs^Fds, Gs^Fds, Gs^Fds, Gs^Fds, Gs^Fds, Wwt, Gs^Fds, Gs^Fds, Gs^Fds, Gs^Fds, Wwt, Gd, Rb^Es, Gll^Fdf, Gll^Fdf, Mm, Mm^Xm, Mm^Xm
Mm^Xm, Mm, Hh, Gll^Fdf, Gll^Fdf, Gll^Fdf, Gll^Fdf, Gd^Es, Gs^Fds, Gs^Fds, Gs^Fds, Gs^Fds, Gs^Fds, Gs^Fds, Wwt, Ww^Bw\, Gg^Efm, Gs^Fds, Gs^Fds, Gs^Fds, Gs^Fds, Gs^Fds, Gs^Fds, Gs^Fds, Gs^Fds, Gs^Fds, Gs^Fds, Gs^Fds, Gs^Fds, Gg^Fet, Gs^Fds, Gs^Fds, Gs^Fds, Gs^Fds, Gs^Fds, Gs^Fds, Gs^Fds, Gg^Efm, Ww^Bw\, Wwt, Gs^Fds, Wwt, Wwt, Gs^Fds, Gs^Fds, Wwrt, Gs^Fds, Gll^Fdf, Gll^Fdf, Gll^Fdw, Hh, Mm, Mm^Xm
Mm^Xm, Mm^Xm, Mm, Gll^Fdf, Rb^Fdyu, Gll^Fdf, Rb^Es, Gs^Fds, Gs^Fds, Gs^Fds, Gg^Fet, Gs^Fds, Gs^Fds, Gs^Fds, Wwt, Gs^Fds, Gs^Fds, Gs^Fds, Gs^Fds, Gs^Fds, Gs^Fds, Gs^Fds, Gs^Fds, Gs^Fds, Gs^Fds, Gs^Fds, Gs^Fds, Gs^Fds, Gs^Fds, Gs^Fds, Gs^Fds, Gs^Fds, Gs^Fds, Gs^Fds, Gs^Fds, Gs^Fds, Gs^Fds, Gg^Fet, Wwt, Gg^Efm, Gs^Fds, Gs^Emf, Wwt, Gs^Fds, Gs^Fds, Wwrt, Gs^Fds, Gd^Fetd, Gll^Fdf, Gll^Fdw, Hh^Dr, Mm^Xm, Mm^Xm
Mm^Xm, Mm^Xm, Hh, Hh, Gs, Gll^Fdf, Gll^Fdf, Gs^Fds, Gs^Fds, Gs^Fds, Gs^Fds, Gs^Fds, Gs^Fds, Gs^Fds, Wwt, Gs^Fds, Gg^Fet, Gs^Fds, Wwt, Gs^Fds, Gs^Fds, Gs^Fds, Gs^Fds, Gs^Fds, Gs^Fds, Gs^Fds, Gg^Fet, Gs^Fds, Gs^Fds, Gs^Fds, Gs^Fds, Gs^Fds, Gs^Fds, Gs^Fds, Wwt, Gs^Fds, Gs^Fds, Gs^Fds, Wwt, Gs^Em, Gs^Fds, Gs^Fds, Gs^Fds, Wwt, Wwt, Wwt, Gs^Fds, Gs^Es, Rb^Fdyu, Hh, Mm, Mm, Mm^Xm
Mm^Xm, Mm, Mm, Hh, Rb^Es, Gs^Es, Gll^Fdw, Rb^Fdyu, Gs^Fds, Gs^Fds, Gs^Fds, Gs^Fds, Gs^Fds, Gs^Fds, Gs^Fds, Wwrt, Wwt, Wwt, Gs^Fds, Wwt, Wwt, Gs^Fds, Gs^Fds, Gs^Fds, Gs^Fds, Gg^Fet, Rp, Gg^Fet, Gs^Fds, Gs^Fds, Gs^Fds, Gs^Fds, Wwt, Wwt, Gs^Fds, Wwt, Wwt, Wwt, Gs^Fds, Gs^Fds, Gs^Fds, Gs^Fds, Gs^Fds, Gs^Fds, Gs^Fds, Gs^Fds, Gs^Fds, Gll^Fdf, Gll^Fdf, Hh, Hh, Mm, Mm^Xm
Mm^Xm, Mm^Xm, Mm, Hh, Gll^Fdw, Gll^Fdf, Gll^Fdf, Rb^Fdyu, Gs^Fds, Gs^Fds, Gs^Fds, Gg^Fet, Gs^Fds, Gs^Fds, Gs^Fds, Gs^Fds, Gs^Fds, Gs^Fds, Gs^Fds, Gs^Fds, Wwt, Gs^Fds, Gs^Fds, Gs^Fds, Gs^Fds, Gs^Fds, Rp, Gs^Fds, Gs^Fds, Gs^Fds, Gs^Fds, Gs^Fds, Wwt, Gs^Fds, Gs^Fds, Gs^Fds, Gs^Fds, Gs^Fds, Gs^Fds, Gs^Fds, Gs^Fds, Gs^Fds, Gs^Fds, Gs^Fds, Gs^Fds, Gs^Fds, Gll^Fdf, Gll^Fdf, Gll^Fdf, Gs^Fds, Mm, Mm^Xm, Mm^Xm
Mm^Xm, Mm^Xm, Hh, Gll^Fdw, Gll^Fdf, Gll^Fdf, Rb^Fdyu, Gll^Fdf, Gll^Fdf, Gs^Fds, Gs^Fds, Gs^Fds, Gs^Fds, Gs^Fds, Gs^Fds, Gs^Fds, Gs^Fds, Gs^Fds, Gs^Fds, Gs^Fds, Wwt, Gs^Fds, Gs^Fds, Gs^Fds, Gg^Efm, Rp, Gg^Imc, Rp, Gg^Efm, Gs^Fds, Gs^Fds, Gs^Fds, Wwt, Gs^Fds, Gs^Fds, Gs^Fds, Gs^Fds, Gs^Fds, Gs^Fds, Gs^Fds, Gs^Fds, Gs^Fds, Gs^Fds, Gs^Fds, Gs^Fds, Gll^Fdf, Rb^Fdyu, Rb^Es, Gll^Fdf, Gs^Fds, Mm, Mm, Mm^Xm
Mm^Xm, Hh^Dr, Hh, Gll^Fdw, Gll^Fdf, Rb^Es, Gll^Fdf, Gll^Fdf, Gs^Fds, Gs^Fds, Gs^Fds, Gg^Fet, Gs^Fds, Gs^Fds, Gs^Fds, Gs^Fds, Gs^Fds, Gs^Fds, Gs^Fds, Gg^Fet, Gs^Fds, Wwrt, Wwt, Gs^Ima, Wwt, Wwt, Wwt, Wwt, Wwt, Gs^Ima, Wwt, Wwrt, Gs^Fds, Gg^Fet, Gs^Fds, Gs^Fds, Gs^Fds, Gg^Fet, Gs^Fds, Gs^Fds, Gs^Fds, Gs^Fds, Gs^Fds, Gs^Fds, Gs^Fds, Gll^Fdf, Gd^Fetd, Gll^Fdw, Gll^Fdw, Hh, Hh, Mm, Mm^Xm
Mm^Xm, Mm^Xm, Mm, Gll^Fdw, Re, Gll^Fdf, Rb^Fdyu, Gll^Fdf, Gs^Fds, Gs^Fds, Gs^Fds, Gs^Fds, Gs^Fds, Gs^Fds, Gg^Fet, Gs^Fds, Gs^Fds, Gs^Fds, Gs^Fds, Gs^Fds, Gs^Fds, Gs^Fds, Gs^Fds, Wwt, Wot^Crys, Wot^Crys, Wot^Crys, Wot^Crys, Wot^Crys, Wwt, Gs^Fds, Gs^Fds, Gs^Fds, Gs^Fds, Gs^Fds, Gs^Fds, Gs^Fds, Gs^Fds, Gs^Fds, Gs^Fds, Gs^Fds, Gs^Fds, Gs^Fds, Gs^Fds, Gs^Fds, Gll^Fdf, Gll^Fdf, Rb^Es, Rb^Fdyu, Hh, Mm, Mm, Mm^Xm
Mm^Xm, Mm^Xm, Mm, Hh, Gs^Es, Gd^Fetd, Gs, Gll^Fdf, Gs^Fds, Gs^Fds, Gs^Fds, Gs^Fds, Gs^Fds, Gs^Fds, Gg^Fet, Gg^Fet, Gg^Fet, Gs^Fds, Gs^Fds, Gs^Fds, Gs^Fds, Gg^Fet, Gs^Fds, Wwt, Wot^Crys, Wot^Crys, Wot^Crys, Wot^Crys, Wot^Crys, Wwt, Gs^Fds, Gg^Fet, Gs^Fds, Gs^Fds, Gs^Fds, Gs^Fds, Gs^Fds, Gg^Fet, Gs^Fds, Gs^Fds, Gs^Fds, Gs^Fds, Gs^Fds, Gs^Fds, Rb^Fdyu, Rb, Gll^Fdf, Gll^Fdw, Mm, Mm, Mm, Mm^Xm, Mm^Xm
Mm^Xm, Mm^Xm, Mm, Mm, Gll^Fdf, Gll^Fdf, Gll^Fdw, Gs^Fds, Gs^Fds, Gs^Fds, Gs^Fds, Gs^Fds, Gs^Fds, Gs^Fds, Gs^Fds, Gs^Fds, Gs^Fds, Gs^Fds, Gs^Fds, Gs^Fds, Gs^Fds, Gs^Fds, Wwt, Wwt, Wwt, Wot^Crys, Wwt, Wot^Crys, Wwt, Wwt, Wwt, Gs^Fds, Gs^Fds, Gs^Fds, Gs^Fds, Gs^Fds, Gs^Fds, Gs^Fds, Gs^Fds, Gg^Fet, Gs^Fds, Gs^Fds, Gs^Fds, Gs^Fds, Gs^Es, Gd, Re, Gll^Fdf, Mm, Mm, Mm, Mm^Xm, Mm^Xm
Mm^Xm, Mm^Xm, Mm, Mm, Mm, Gll^Fdf, Re^Dr, Gll^Fdf, Gll^Fdf, Gs^Fds, Gs^Fds, Gs^Fds, Gs^Fds, Gs^Fds, Gs^Fds, Gs^Fds, Gs^Fds, Gs^Fds, Gs^Fds, Gg^Fet, Wwt, Wwrt, Gs^Fds, Gs^Ima, Gg^Efm, Wwt, Gg^Imc, Wwt, Gg^Efm, Gs^Ima, Gs^Fds, Wwt, Gs^Fds, Gg^Fet, Gs^Fds, Gs^Fds, Gs^Fds, Gs^Fds, Gs^Fds, Gs^Fds, Gs^Fds, Gs^Fds, Gs^Fds, Gs^Fds, Gs^Fds, Gs^Fds, Gll^Fdf, Gll^Fdw, Hh, Mm, Mm, Mm^Xm, Mm^Xm
Mm^Xm, Mm^Xm, Mm^Xm, Mm, Mm, Gll^Fdw, Gll^Fdf, Gll^Fdf, Gll^Fdf, Gs^Fds, Gs^Fds, Gs^Fds, Gg^Fet, Gs^Fds, Gs^Fds, Gs^Fds, Gs^Fds, Gs^Fds, Gs^Fds, Gs^Fds, Wwrt, Gs^Fds, Gs^Fds, Gs^Fds, Gs^Fds, Rp, Rp, Rp, Gs^Fds, Gs^Fds, Gs^Fds, Wwt, Wwt, Gs^Fds, Wwt, Wwt, Wwt, Gs^Emf, Gg^Efm, Gs^Fds, Gg^Fet, Gs^Fds, Gs^Fds, Gs^Fds, Gd^Fetd, Gll^Fdf, Rb^Fdyu, Gll^Fdf, Hh, Mm, Mm, Mm^Xm, Mm^Xm
Mm^Xm, Mm^Xm, Mm^Xm, Mm, Mm, Gll^Fdf, Gs^Es, Rb^Fdyu, Gs^Fds, Gs^Fds, Gs^Fds, Gg^Fet, Gg^Fet, Gs^Fds, Gs^Fds, Gs^Fds, Gs^Fds, Gs^Fds, Wwt, Wwrt, Gs^Fds, Gs^Fds, Gs^Fds, Gs^Fds, Gs^Fds, Gs^Fds, Rp, Gs^Fds, Gs^Fds, Gs^Fds, Gs^Fds, Gs^Fds, Gs^Fds, Wwt, Gs^Fds, Gs^Fds, Gg, Wwt^Bw/, Gs^Fds, Gs^Fds, Gs^Fds, Gs^Fds, Gs^Fds, Gs^Fds, Gs^Fds, Gll^Fdf, Gll^Fdf, Gll^Fdw, Hh, Hh, Mm, Mm^Xm, Mm^Xm
Mm^Xm, Mm^Xm, Mm, Mm, Hh, Rb^Fdyu, Gll^Fdf, Gs^Fds, Gs^Fds, Gs^Fds, Gs^Fds, Gs^Fds, Gs^Fds, Gs^Fds, Gs^Fds, Gs^Fds, Gs^Fds, Gs^Fds, Wwt, Gs^Emf, Gs^Fds, Gs^Fds, Gs^Fds, Gs^Fds, Gs^Fds, Gg^Fet, Gg^Fet, Gg^Fet, Gs^Fds, Gs^Fds, Gs^Fds, Gs^Fds, Gs^Fds, Gg, Gs^Fds, Gs^Fds, Gs^Fds, Wwt, Gs^Fds, Gg^Fet, Gs^Fds, Gs^Fds, Gg^Fet, Gs^Fds, Gs^Fds, Gs^Fds, Gll^Fdw, Gll^Fdf, Hh, Hh, Mm, Mm^Xm, Mm^Xm
Mm^Xm, Mm^Xm, Hh, Hh, Gll^Fdw, Gll^Fdf, Gll^Fdf, Gll^Fdf, Rb^Fdyu, Gs^Fds, Gs^Fds, Gs^Fds, Gs^Fds, Gs^Fds, Gs^Fds, Gs^Fds, Wwt, Gg^Fet, Wwt, Gs^Fds, Gs^Fds, Gs^Fds, Gs^Fds, Gs^Fds, Gs^Fds, Gs^Fds, Gs^Fds, Gs^Fds, Gs^Fds, Gs^Fds, Gs^Fds, Gs^Fds, Gs^Fds, Gs^Fds, Gs^Fds, Gs^Fds, Gs^Fds, Wwt, Wwt, Gs^Fds, Gs^Fds, Gg^Fet, Gg^Fet, Gs^Fds, Gs^Fds, Gs, Rb, Gll^Fdw, Hh, Mm, Mm, Mm^Xm, Mm^Xm
Mm^Xm, Mm, Hh, Re^Dr, Gll^Fdw, Re^Es, Rb, Gll^Fdf, Gd^FYok, Gs^Fds, Gs^Fds, Gs^Fds, Gs^Fds, Gs^Fds, Gs^Fds, Wwt, Gs^Fds, Wwt, Gs^Fds, Gs^Fds, Gs^Fds, Gs^Fds, Gs^Fds, Gs^Fds, Gs^Fds, Gs^Fds, Gs^Fds, Gs^Fds, Gs^Fds, Gs^Fds, Gs^Fds, Gs^Fds, Gs^Fds, Gs^Fds, Gs^Fds, Gs^Fds, Gs^Fds, Gs^Fds, Gg^Fet, Wwt, Gs^Fds, Gs^Fds, Gs^Fds, Gs^Fds, Gs^Fds, Gd^Es, Gll^Fdw, Rb^Fdyu, Gll^Fdf, Hh^Dr, Mm, Mm^Xm, Mm^Xm
Mm^Xm, Mm^Xm, Hh, Gll^Fdw, Gll^Fdf, Gll^Fdf, Rb^Es, Rd^Es, Rb, Gll^Fdf, Gs^Fds, Gs^Fds, Gs^Fds, Gs^Fds, Gs^Fds, Wwt, Wwt, Gs^Fds, Gs^Fds, Gs^Fds, Gs^Fds, Gg^Fet, Gs^Fds, Gs^Fds, Gs^Fds, Gs^Fds, Gs^Fds, Gs^Fds, Gs^Fds, Gs^Fds, Gs^Fds, Gs^Fds, Gs^Fds, Gg^Fet, Gs^Fds, Gs^Fds, Gs^Fds, Gs^Fds, Wwt, Wwt, Gs^Fds, Gs^Fds, Gs^Fds, Gs^Fds, Gs^Fds, Gs^Fds, Gd^Fetd, Gll^Fdf, Gll^Fdf, Hh, Hh, Mm^Xm, Mm^Xm
Mm^Xm, Mm, Hh, Gll^Fdw, Hh, Gll^Fdf, Gll^Fdw, Gll^Fdf, Gs^Fds, Gs^Fds, Gs^Fds, Gs^Fds, Gs^Fds, Gs^Fds, Gg, Gs^Fds, Wwt, Gs^Fds, Gs^Fds, Gs^Fds, Gs^Fds, Gs^Fds, Gs^Fds, Gs^Fds, Gs^Fds, Gs^Fds, Gs^Fds, Gs^Fds, Gs^Fds, Gs^Fds, Gg^Fet, Gs^Fds, Gs^Fds, Gs^Fds, Gs^Fds, Gs^Fds, Gs^Fds, Wwt, Gs^Fds, Gs^Fds, Gs^Fds, Gs^Fds, Gs^Fds, Gs^Fds, Gll^Fdf, Gs^Fds, Gll^Fdw, Gd^Es, Gll^Fdw, Hh, Mm, Mm^Xm, Mm^Xm
Mm^Xm, Mm, Mm, Hh, Hh, Hh, Gll^Fdw, Rb^Fdyu, Gll^Fdw, Gll^Fdf, Gs^Fds, Gs^Fds, Gs^Fds, Gs^Fds, Wwt, Ww^Bw\, Gg^Efm, Gg^Fet, Gs^Fds, Gs^Fds, Gg^Fet, Gg^Fet, Gs^Fds, Gs^Fds, Gg^Fet, Gs^Fds, Gs^Fds, Gs^Fds, Gs^Fds, Gg^Fet, Gs^Fds, Gg^Fet, Gg^Fet, Gs^Fds, Gs^Fds, Gs^Fds, Gs^Fds, Wwt, Wwt, Gs^Fds, Gs^Fds, Gs^Fds, Gs^Fds, Gs^Fds, Gs, Gll^Fdw, Gll^Fdf, Rb^Fdyu, Hh, Hh, Mm, Mm^Xm, Mm^Xm
Mm^Xm, Mm^Xm, Mm^Xm, Mm, Mm, Hh, Hh, Gll^Fdf, Gll^Fdf, Gll^Fdf, Gll^Fdw, Gs^Fds, Gs^Fds, Gs^Fds, Wwt, Gs^Fds, Gs^Fds, Gs^Fds, Gs^Fds, Gs^Fds, Gs^Fds, Gs^Fds, Gs^Fds, Gs^Fds, Gs^Fds, Gs^Fds, Gg^Fet, Gs^Fds, Gs^Fds, Gs^Fds, Gs^Fds, Gs^Fds, Gs^Fds, Gs^Fds, Gs^Fds, Gs^Fds, Gs^Fds, Gs^Fds, Wwt, Gs^Fds, Gs^Fds, Gs^Fds, Gll^Fdf, Gll^Fdf, Re^Dr, Gs^Es, Rb^Fdyu, Rb^Fdyu, Mm, Mm, Mm^Xm, Mm^Xm, Mm^Xm
Mm^Xm, Mm^Xm, Mm^Xm, Mm^Xm, Mm^Xm, Mm, Mm, Hh, Hh, Gll^Fdf, Gll^Fdf, Gll^Fdw, Gll^Fdf, Wwt, Gs^Fds, Gs^Fds, Gs^Fds, Gs^Fds, Gg^Fet, Gs^Fds, Gs^Fds, Gs^Fds, Gs^Fds, Gs^Fds, Gs^Fds, Gs^Fds, Gs^Fds, Gs^Fds, Gs^Fds, Gs^Fds, Gs^Fds, Gs^Fds, Gg^Fet, Gs^Fds, Gs^Fds, Gs^Fds, Gs^Fds, Wwt, Wwt, Gs^Fds, Wwt, Gll^Fdf, Hh, Gll^Fdf, Hh, Hh, Mm, Mm, Mm^Xm, Mm^Xm, Mm^Xm, Mm^Xm, Mm^Xm
Mm^Xm, Mm^Xm, Mm^Xm, Mm^Xm, Mm^Xm, Mm^Xm, Mm, Mm, Mm, Hh, Wwt, Gll^Fdf, Gll^Fdf, Wwrt, Gll^Fdf, Gs^Fds, Gs^Fds, Gs^Fds, Gs^Fds, Gs^Fds, Gs^Fds, Gs^Fds, Gs^Fds, Gs^Fds, Gs^Fds, Gs^Fds, Gs^Fds, Gs^Fds, Gs^Fds, Gs^Fds, Gs^Fds, Gs^Fds, Gs^Fds, Gs^Fds, Gs^Fds, Gs^Fds, Gs^Fds, Gs^Fds, Gs^Fds, Wwt, Wwt, Gll^Fdf, Hh, Hh, Mm, Mm, Mm, Mm^Xm, Mm^Xm, Mm^Xm, Mm^Xm, Mm^Xm, Mm^Xm
Mm^Xm, Mm^Xm, Mm^Xm, Mm^Xm, Mm^Xm, Mm^Xm, Mm^Xm, Mm, Wwt, Wwt, Mm, Wwt, Wwt, Wwt, Gll^Fdf, Gll^Fdw, Rb^Es, Gll^Fdf, Gll^Fdw, Gs^Fds, Gll^Fdf, Gs^Fds, Gs^Fds, Gs^Fds, Gll^Fdw, Gs^Fds, Gs^Fds, Gs^Fds, Gs^Fds, Gs^Fds, Gll^Fdf, Gs^Fds, Gll^Fdf, Gs^Fds, Gs^Fds, Gs^Fds, Gs^Fds, Gs^Fds, Gll^Fdf, Gs^Fds, Re^Es, Wwt, Mm, Mm, Mm, Mm, Mm, Mm^Xm, Mm^Xm, Mm^Xm, Mm^Xm, Mm^Xm, Mm^Xm
Mm^Xm, Mm^Xm, Mm^Xm, Mm^Xm, Mm, Mm, Mm, Mm, Wwt, Mm, Mm, Mm, Mm, Gd^Es, Gs, Gll^Fdf, Gll^Fdf, Gll^Fdf, Re^Es, Gll^Fdf, Gll^Fdf, Gd^Es, Gd, Gll^Fdf, Gll^Fdf, Gll^Fdf, Gll^Fdf, Gs^Fds, Gs^Fds, Gll^Fdf, Gll^Fdf, Re^Es, Gs^Es, Gd^FYok, Gll^Fdw, Gs^Fds, Gll^Fdf, Gll^Fdf, Hh, Gll^Fdf, Mm, Wwt, Mm, Mm, Wwt, Mm, Wwt, Mm, Mm, Mm^Xm, Mm^Xm, Mm^Xm, Mm^Xm
Mm^Xm, Mm^Xm, Mm^Xm, Mm^Xm, Mm^Xm, Mm, Mm, Mm, Wwt, Mm, Mm^Xm, Mm^Xm, Mm^Xm, Mm, Mm, Gll^Fdf, Rb^Dr, Gll^Fdf, Gll^Fdw, Gll^Fdf, Gd^Fetd, Gll^Fdf, Gll^Fdf, Gll^Fdf, Re, Rb^Fdyu, Rb^Es, Gll^Fdf, Gll^Fdf, Gll^Fdf, Gd^Es, Gll^Fdw, Re^Es, Rb^Fdyu, Gll^Fdf, Hh, Hh, Hh, Mm, Mm, Mm, Wwt, Wwt, Wwt, Mm, Wwt, Mm, Wwt, Mm, Mm, Mm, Mm^Xm, Mm^Xm
Mm^Xm, Mm^Xm, Mm^Xm, Mm^Xm, Wwt, Wwt, Wwt, Wwt, Mm, Mm, Mm^Xm, Mm^Xm, Mm^Xm, Mm^Xm, Mm^Xm, Mm, Mm, Rb^Dr, Gll^Fdf, Gll^Fdw, Gll^Fdf, Gll^Fdf, Rd^Es, Gll^Fdf, Gll^Fdf, Rd^Es, Gll^Fdf, Gll^Fdw, Gll^Fdf, Rb^Fdyu, Gll^Fdf, Re, Gll^Fdf, Gll^Fdf, Rb^Fdyu, Hh, Mm, Mm, Mm, Mm, Mm^Xm, Mm, Mm, Mm, Mm^Xm, Mm, Mm, Wwt, Wwt, Mm, Mm, Mm^Xm, Mm^Xm
Mm^Xm, Mm^Xm, Mm^Xm, Mm^Xm, Wwt, Mm, Mm^Xm, Mm, Mm^Xm, Mm^Xm, Mm^Xm, Mm^Xm, Mm^Xm, Mm^Xm, Mm^Xm, Mm^Xm, Mm^Xm, Mm, Mm, Gll^Fdf, Hh, Gll^Fdw, Hh, Gll^Fdf, Hh, Gll^Fdf, Hh, Rb^Dr, Hh, Gll^Fdf, Hh, Gll^Fdf, Hh, Gll^Fdf, Mm, Mm, Mm^Xm, Mm, Mm^Xm, Mm^Xm, Mm^Xm, Mm^Xm, Mm^Xm, Mm^Xm, Mm^Xm, Mm^Xm, Mm^Xm, Mm, Mm^Xm, Wwt, Mm^Xm, Mm^Xm, Mm^Xm
Mm^Xm, Mm^Xm, Mm^Xm, Mm^Xm, Wwt, Mm^Xm, Mm^Xm, Mm^Xm, Mm^Xm, Mm^Xm, Mm^Xm, Mm^Xm, Mm^Xm, Mm^Xm, Mm^Xm, Mm^Xm, Mm^Xm, Mm^Xm, Mm^Xm, Mm, Mm, Hh, Mm, Hh, Mm, Hh, Mm, Hh, Mm, Hh, Mm, Hh, Mm, Mm, Mm^Xm, Mm^Xm, Mm^Xm, Mm^Xm, Mm^Xm, Mm^Xm, Mm^Xm, Mm^Xm, Mm^Xm, Mm^Xm, Mm^Xm, Mm^Xm, Mm^Xm, Mm^Xm, Mm^Xm, Wwt, Wwt, Mm^Xm, Mm^Xm
Mm^Xm, Mm^Xm, Wwt, Wwt, Mm^Xm, Mm^Xm, Mm^Xm, Mm^Xm, Mm^Xm, Mm^Xm, Mm^Xm, Mm^Xm, Mm^Xm, Mm^Xm, Mm^Xm, Mm^Xm, Mm^Xm, Mm^Xm, Mm^Xm, Mm^Xm, Mm^Xm, Mm^Xm, Mm^Xm, Mm^Xm, Mm^Xm, Mm^Xm, Mm^Xm, Mm^Xm, Mm^Xm, Mm, Mm^Xm, Mm, Mm^Xm, Mm^Xm, Mm^Xm, Mm^Xm, Mm^Xm, Mm^Xm, Mm^Xm, Mm^Xm, Mm^Xm, Mm^Xm, Mm^Xm, Mm^Xm, Mm^Xm, Mm^Xm, Mm^Xm, Mm^Xm, Mm^Xm, Mm^Xm, Mm^Xm, Wwt, Mm^Xm
Wwt, Wwt, Mm, Mm^Xm, Mm^Xm, Mm^Xm, Mm^Xm, Mm^Xm, Mm^Xm, Mm^Xm, Mm^Xm, Mm^Xm, Mm^Xm, Mm^Xm, Mm^Xm, Mm^Xm, Mm^Xm, Mm^Xm, Mm^Xm, Mm^Xm, Mm^Xm, Mm^Xm, Mm^Xm, Mm^Xm, Mm^Xm, Mm^Xm, Mm^Xm, Mm^Xm, Mm^Xm, Mm^Xm, Mm^Xm, Mm^Xm, Mm^Xm, Mm^Xm, Mm^Xm, Mm^Xm, Mm, Mm^Xm, Mm^Xm, Mm^Xm, Mm^Xm, Mm^Xm, Mm^Xm, Mm^Xm, Mm^Xm, Mm^Xm, Mm^Xm, Mm^Xm, Mm^Xm, Mm^Xm, Mm^Xm, Wwt, Mm^Xm
