border_size=1
usage=map

Ket, Ket, Ket, Ket, Ket, Ket, Ket, Ket, Ket, Ket, Ket, Ket, Ket, Ket, Ket, Ket, Ket
Ket, Iwr^Ys8, Iwr, Iwr^Ys8, Iwr, Iwr^Ys8, Iwr, Iwr^Ys8, Iwr, Iwr^Ys8, Iwr, Iwr^Ys8, Iwr, Iwr^Ys8, Iwr, Iwr^Ys8, Ket
Ket, Iwr, Iwr^Y5, Iwr^Y9, Iwr, Iwr^Ys26, Iwr, Iwr^Ys33, 2 Iwr, Iwr^Ys25, Iwr, Iwr^Ys25, Iwr, Iwr, Iwr^Ys4, Iwr, Ket
Ket, Iwr^Ys41, Iwr^Ys2, Iwr^Ys2, Iwr^Ys2, Iwr^Ys37, Iwr, Iwr^Ys37, Iwr, Iwr^Ys37, Iwr, Iwr^Ys37, Iwr^Ys12, Iwr^Y4, Iwr^Y10, Iwr^Ys19, Ket
Ket, Iwr^Ys2, Iwr^Ys2, Iwr^Ys57, Iwr^Ys30, Iwr^Ys30, Iwr, Iwr, Iwr, Iwr, Iwr, Iwr^Ys31, Iwr^Ys31, Iwr^Ys12, Iwr^Ys12, Iwr^Ys40, Ket
Ket, Iwr^Ys2, Iwr^Ys30, Iwr^Ys30, Iwr, Iwr, Iwr, Iwr, Iwr, Iwr, Iwr, Iwr, Iwr, Iwr^Ys31, Iwr^Ys31, Iwr^Ys12, Ket
Ket, Iwr, Iwr^Y10, Iwr, Iwr, Iwr, Iwr, Iwr, Iwr, Iwr, Iwr, Iwr, Iwr, Iwr, Iwr^Y9, Iwr, Ket
Ket, Iwr^Ys54, Iwr, Iwr, Iwr, Iwr, Iwr, Iwr, 1 Iwr^Ii, Iwr, Iwr, Iwr, Iwr, Iwr, Iwr, Iwr^Ys55, Ket
Ket, Ket, Ket, Ket, Ket, Ket, Ket, Re^Ys16, Re, Re^Ys15, Ket, Ket, Ket, Ket, Ket, Ket, Ket
