border_size=1
usage=map

Gs^Fds, Gs^Fds, Gs^Fds, Gll^Fp, Gll^Fp, Gg, Rb, Sm, Ss, Ss, Ss, Ss, Ss, Ss, Ss, Ss, Ss, Ss, Wwg, Ss, Ss, Ss, Ss, Ss, Ss, Ss, Ss, Ss, Ss, Ss, Ss, Ss, Ss, Ss, Ss, Ss, Ss, Ss, Ss, Ss, Ss
Gs^Fds, Gs^Fds, Gs^Fds, Gll^Fp, Gll^Fp, Gg, Rb, Sm, Ss, Ss, Gg, Sm, Sm, Ss, Wwf, Ss, Ss, Wwf, Wwg, Ww^Ewl, Gg, Ss, Ss, Ss, Sm, Ss, Sm, Ss, Ss, Ss, Ss, Ss, Ss, Ss, Ss, Sm, Gg, Sm, Ss, Ss, Ss
Gs^Fds, Gs^Fds, Gll^Fp, Gll^Fp, Gll^Fp, Rb, Rb^Es, Sm, Sm^Em, Ss, Gg^Es, Ss^Vhs, Gg, Ss, Ss, Ss, Ss, Wwf, Wwg, Ss, Gg, Gd, Rb, Rb, Gg, Ss^Vhs, Gd^Fetd, Gg, Sm, Ss, Ss, Wwg, Ww^Ewl, Ss, Ss, Ss^Vhs, Gd, Gg, Ss, Sm^Em, Sm
Gs^Fds, Gll^Fp, Gll^Fp, Gg, Rb, Rb, Sm, Sm, Ss, Ss, Sm, Gd, Gg^Es, Sm, Wwg, Wwg, Ss, Sm, Gd^Es, Wwg^Bw/r, Ww^Ewf, Ss, Wwf, Ss, Sm, Gd, Gd^Es, Gll^Fdw, Sm, Ss, Wwg, Wwf, Wwf, Wwg, Ss, Sm, Sm, Sm^Em, Sm, Sm, Rb
Gs^Fds, Gll^Fp, Gs^Fds, Rb^Es, Rb, Sm^Em, Sm, Sm, Ss, Wwf, Wwf, Ss, Ss, Ss, Wwg, Wwf, Ss, Gd^Fetd, Gg, Gg, Ss, Wwf, Ss, Ss, Ss, Gg, Sm, Gg, Rb, Ss, Ww^Ewl, Wwf, Wwg, Wwg, Ss, Ss, Ss, Ss, Sm, Sm, Rb
Gs^Fds, Gs^Fds, Gll^Fp, Gd, Rb^Es, Rb, Sm, Sm, Ss, Wwf, Wwg, Ss, Sm, Ss, Ss, Ss, Ss, Gll^Fdw, Sm, Gd^Es, Rb, Ss, Gg, Sm^Em, Sm, Ss, Ww^Ewl, Ss, Sm, Ss, Ss, Wwg, Ss, Ww^Ewl, Ss, Sm, Sm, Rb, Rb, Rb, Gg
Gs^Fds, Gs^Fds, Gs^Fds, Gg, Gg, Rb, Rb^Es, Sm, Sm, Ss, Ss, Sm, Gll^Fdw, Gg, Ss^Vhs, Ss, Ss, Ss, Wwf, Ss, Ss, Gg, Gd^Fetd, Ss, Gg, Ss, Wwg, Wwf, Ss, Rb^Es, Ss, Ss, Ss, Ss, Sm, Sm, Rb, Rb, Rb^Es, Rb, Gg
Gs^Fds, Gs^Fds, Gs^Fds, Gll^Fp, Gg, Rb, Sm, Sm, Ss, Ss, Ss, Sm, Gg, Gd, Gll^Fdw, Sm, Ss, Wwg, Wwg, Wwf, Ss, Gll^Fdw, Gg, Gd, Gll^Fdw, Ss, Ss, Ss, Gg, Gg, Ss^Vhs, Ss, Ss, Sm^Em, Sm, Rb^Es, Rb, Gg, Gg, Gg, Gg
Gs^Fds, Gll^Fp, Gs^Fds, Gs^Fds, Rb^Es, Rb, Sm, Sm^Em, Ss, Wwg, Ww^Ewl, Ss, Ss, Gg^Es, Sm, Ss, Ss, Ss, Ss, Wwg, Ss, Sm, Rb, Sm, Ss, Ss, Ss, Sm^Em, Gg, Gg, Gll^Fdw, Sm, Ss, Ss, Sm, Rb, Gg, Gg, Gd, Gg, Gg
Gs^Fds, Gs^Fds, Gg^Emf, Gll^Fp, Gll^Fp, Rb, Rb, Sm, Ss, Wwg, Ss, Gg, Sm^Em, Ss, Wwf, Ss, Rb, Gg, 2 Gd^Fetd, Ss, Ss, Ss, Rb^Es, Ss, Wwg, Wwg, Ss, Ss, Ss^Bw|r, Sm, Ss, Ss, Ss, Sm, Rb, Rb, Rb, Gg, Gd, Gg, Gg
Gs^Fds, Gs^Fds, Gs^Vc, 3 Gg^Kov, Gs^Fds, Rb^Es, Rb, Sm, Ss, Ss, Sm, Gll^Fdw, Gg, Ss, Ss, Ss, Sm, Gg^Es, Sm, Ss, Ss, Sm, Ss, Wwg, Ww^Ewf, Ww^Ewl, Ss, Sm, Gg, Ss, Wwf, Wwg, Ss, Ss, Sm^Em, Rb^Es, Rb^Cov, Gg, Gg, Gg, Re
Gs^Fds, Gs^Fds, Rp, Rd, Gll^Fp, Gll^Fp, Rb, Sm, Sm^Em, Ss, Sm, Gg, Ss, Ss, Wwg, Wwg, Ss, Ss, Sm, Ss, Ss, Rb, Ss, Ss, Ss, Ss, Gll^Fdw, Gg, Gd, Ss, Ss, Wwg, Rb, Rb, Rb, Ke, Ke, Re^Cov, Re, Re, Gg
Gs^Fds, Gs^Fds, Rp, Gs^Fds, Rb^Es, Rb, Sm, Sm, Ss, Ss, Ss, Sm, Gll^Fdw, Ss, Ss, Wwf, Ss, Ss, Gg, Gll^Fdw, Gg, Rb, Ss, Wwg, Wwf, Ss, Sm, Gg, Sm, Rb^Es, Re, Sm, Ss, Ss, Sm, 1 Ke, Rb^Cov, Gg^Cov, Gg, Gg, Gg
Gs^Fds, Gg, Gg^Efm, Rp, Rb, Sm, Sm^Bw/r, Rb, Rb, Rb^Es, Gg, Gg, Gg, Ss, Ss, Ss, Ss, Sm, Ss^Vhs, Gd, Gll^Fdw, Sm^Em, Ss, Wwg, Ss, Ss, Rb, Rb, Ss, Ss, Ss, Ss, Ss, Ss, Sm, Rb, Rb, Rb, Gg, Gd, Gg
Gs^Fds, Gs^Fds, Gg, Rp, Re, Re, Sm, Sm, Ss, Ss, Sm, Gd^Es, Gg, Gd^Fetd, Ss, Wwf, Ww^Ewl, Ss, Ss, Gg, Gg, Sm, Wwf, Ss, Sm, Sm, Rb^Es, Ss, Ss, Ss, Ss, Ss, Ss, Ss, Sm, Rb^Es, Rb, Gg, Gd, Gg, Gg
Gs^Fds, Gs^Fds, Gs^Fds, Gg, Rb, Sm^Em, Rb, Sm, Ss, Ss, Ss, Ss, Rb^Es, Ss, Wwf, Wwg, Ww^Ewl, Ww^Ewl, Ss, Sm, Sm^Em, Ss, Ss, Ss, Gll^Fdw, Gg, Gg, Ss, Ss, Ss, Ss, Ss, Ss, Sm, Sm, Rb, Rb, Gg, Gg, Gg, Gg
Gll^Fp, Gll^Fp, Gll^Fp, Gs^Fds, Gg, Rb, Rb, Sm, Ss, Wwf, Wwf, Gd, Gg, Ss, Wwf, Wwg, Ss, Ww^Ewl, Wwg^Bw/r, Rb, Wwf, Ss, Wwf, Sm, Sm^Em, Gd^Fetd, Gg, Sm, Wwg, Ss, Gg^Em, Ss, Ss, Sm, Sm^Em, Sm, Rb^Es, Rb, Rb, Rb, Rb
Gs^Fds, Gll^Fp, Gs^Fds, Gll^Fp, Gg, Rb^Es, Rb, Sm^Em, Ss, Wwf, Ss, Gg, Gg^Es, Sm, Ss, Ss, Gg, Rb, Sm, Ww^Ewl, Wwg, Wwg, Wwg, Sm, Sm, Gll^Fdw, Gg^Es, Rb, Wwg^Bw\r, Sm, Gg^Es, Gll^Fdw, Sm, Ss, Sm, Sm, Sm, Sm, Sm, Rb^Es, Rb
Gs^Fds, Gll^Fp, Gs^Fds, Gs^Fds, Gg, Gll^Fp, Rb, Sm, Sm^Em, Ss, Sm, Gll^Fdw, Gd, Ss, Sm, Gll^Fdw, Gd, Gg^Es, Gll^Fdw, Sm, Ss, Wwf, Ss, Ss, Ss, Sm, Ss, Wwg, Wwg, Gg, Gg, Gd, Sm, Ss, Ss, Ss, Ss, Ss, Sm^Em, Sm, Sm
Gs^Fds, Gs^Fds, Gs^Fds, Gg^Efm, Gg, Rb^Es, Rb, Sm, Ss, Ss, Ss, Sm, Ss, Rb, Rb, Gg, Ss^Vhs, Gg, Sm, Ss, Ss, Ss, Ss, Ss, Ss, Ss, Ss, Wwf, Ss, Sm, Ss, Ss^Vhs, Ss, Ss, Ww^Ewl, Ss, Wwg, Ss, Ss, Ss, Ss
Gs^Fds, Gs^Fds, Gs^Fds, Gll^Fp, Gg, Rb, Sm, Sm, Sm^Em, Ss, Ss, Wwg, Wwg, Ss, Ss, Sm, Ss, Ss, Wwg, Ss, Ss, Wwg, Wwf, Wwf, Wwg, Wwg, Wwg, Ss, Ss, Ss, Wwf, Ss, Ss, Ss, Wwg, Wwg, Wwg, Wwf, Ss, Ss, Ss
Gll^Fp, Gll^Fp, Gll^Fp, Gll^Fp, Rb, Rb, Rb^Es, Sm, Sm, Ss, Ss, Wwg, Wwg, Wwf, Ss, Ss, Ss, Wwf, Wwg, Wwg, Ss, Wwg, Wwf, Wwf, Ss, Ww^Ewf, Ss, Ss, Ss, Wwf, Wwg, Wwf, Wwg, Ss, Ss, Wwf, Ss, Ss, Ss, Ss, Ss
Gs^Fds, Gs^Fds, Gs^Fds, Gg, Gg, Rb, Rb, Sm, Gg, Ss, Ss, Wwg, Ss, Ss, Ss, Ss, Ss, Wwg, Ss, Wwg, Ss, Ss, Ss, Ss, Ss, Ss, Ss, Ss, Ss, Wwg, Gg, Wwg, Wwg, Ss, Ss, Ss, Ss, Ss, Ss, Ss, Ss
