border_size=1
usage=map

Dbyu, Dbyu, Dbyu, Dbyu, Dbyu, Dbyu, Dbyu, Dbyu, Dbyu, Dbyu, Uu, Dbyu, Uu, Dbyu, Dbyu, Dbyu, Dbyu, Dbyu, Dbyu, Dbyu, Dbyu, Dbyu, Dbyu, Dbyu, Dbyu, Dbyu, Dbyu, Dbyu, Uh, Dbyu, Dbyu, Dbyu, Dbyu, Dbyu, Dbyu, Dbyu, Dbyu, Dbyu, Qxuz, Xsky, Xsky, Xsky, Xsky
Dbyu, Dbyu, Uu, Dbyu, Dbyu^Es, Dbyu, Dbyu^XpY, Dbyu, Dbyu, Uu, Uh, Uh, Uh, Dbyu, Dbyu^XpY, Dbyu, Dbyu, Dbyu^XpY, Dbyu, Dbyu, Dbyu, Dbyu, Dbyu^XpY, Dbyu, Dbyu, Dbyu, Uh, Uh, Uu^Vu, Uh, Dbyu, Dbyu, Dbyu^XpY, Dbyu, Dbyu^XpY, Dbyu, Dbyu, Dbyu, Qxuz, Xsky, Xsky, Xsky, Xsky
Dbyu, Dbyu, Uh, Uh, Uh, Dbyu, Dbyu, Dbyu, Rb^Fdyu, Uu, Uu^Vu, Uh, Uh, Uu, Dbyu, Dbyu, Rb^Fdyu, Dbyu, Uh, Dbyu, Uu, Dbyu, Dbyu, Dbyu, Rb^Fdyu, Dbyu, Dbyu^XpY, Uh, Uh, Uh, Dbyu, Dbyu, Dbyu, Dbyu^XpY, Dbyu, Dbyu, Dbyu, Uh, Qxuz, Xsky, Xsky, Xsky, Xsky
Uu, Uh, Uu, Uh, Uh, Uu^Es, Dbyu, Rb^Fdyu, Rb^Fdyu, Qxua, Qxua, Qxua, Rb^Fdyu, Dbyu, Dbyu^XpY, Dbyu, Uu, Uu, Uh, Uh, Uh, Dbyu, Dbyu, Rb^Fdyu, Rb^Fdyu, Rb^Fdyu, Uh, Dbyu, Dbyu^XpY, Dbyu, Dbyu, Dbyu^XpY, Dbyu, Dbyu, Rb^Fdyu, Dbyu, Dbyu, Uh, Qxuz, Xsky, Xsky, Xsky, Xsky
Dbyu, Uh, Uh, Uu^Vu, Uh, Dbyu^XpY, Dbyu, Rb^Fdyu, Rb^Fdyu, Rb^Fdyu, Qxua, Qxua, Rb^Fdyu, Rb^Fdyu, Rb^Fdyu, Uh, Qxua, Qxua, Qxua, Uu^Vu, Uh, Uu, Dbyu, Rb^Fdyu, Uh, Rb^Fdyu, Uh, Uu^Es, Uh, Dbyu, Dbyu, Dbyu, Dbyu, Rb^Fdyu, Rb^Fdyu, Rb^Fdyu, Dbyu, Uh, Qxuz, Xsky, Xsky, Xsky, Xsky
Dbyu, Uu, Uh, Uu, Dbyu, Dbyu, Uh, Dbyu, Uh, Dbyu, Dbyu, Rb^Fdyu, Rb^Fdyu, Rb^Fdyu, Uu, Uu^Es, Qxua, Qxua, Qxua, Qxua, Uh, Uu, Dbyu, Dbyu, Dbyu, Uh, Uu, Uu^Vu, Uh, Uh, Dbyu, Dbyu, Dbyu, Dbyu, Dbyu, Dbyu, Uh, Uh, Qxuz, Xsky, Xsky, Xsky, Xsky
Dbyu, Uh, Uu, Dbyu, Dbyu, Uu, Uh, Uh, Uh, Uu, Dbyu^XpY, Dbyu, Dbyu, Dbyu, Dbyu, Uh, Uh, Uh, Uh, Uh, Uu, Uu, Dbyu^XpY, Dbyu^XpY, Dbyu, Dbyu, Dbyu^XpY, Dbyu, Uh, Uh, Dbyu, Dbyu, Dbyu^XpY, Dbyu, Dbyu, Uh, Uh, Uh, Qxuz, Xsky, Xsky, Xsky, Xsky
Dbyu, Dbyu, Dbyu, Dbyu, Dbyu, Dbyu, Uu, Uh, Uu, Dbyu, Rb^Fdyu, Dbyu, Dbyu, Dbyu^XpY, Dbyu, Dbyu, Dbyu, Uu, Dbyu, Uu, Dbyu, Dbyu^XpY, Dbyu^XpY, Dbyu, Rb^Fdyu, Dbyu, Dbyu, Dbyu^XpY, Dbyu, Dbyu, Uu, Dbyu, Dbyu, Dbyu, Uh, Dbyu, Dbyu, Uh, Qxuz, Xsky, Xsky, Xsky, Xsky
Dbyu, Dbyu^XpY, Uh, egDC, Uh, Dbyu, Dbyu, Dbyu, Dbyu^Es, Dbyu, Rb^Fdyu, Rb^Fdyu, Dbyu, Dbyu, Uh, Uh, Uh, Dbyu, Dbyu, Dbyu, Dbyu, Dbyu^XpY, Dbyu, Uh, Rb^Fdyu, Rb^Fdyu, Rb^Fdyu, Dbyu, Uu, Uu^Es, Qxua, Uu, Uu, Dbyu, Uh, Uh, Dbyu, Uh, Qxuz, Xsky, Xsky, Xsky, Xsky
Uh, Uh, egDC, Urb, egDC, Uh, Uh, Dbyu, Dbyu^XpY, Dbyu, Dbyu, Dbyu, Uh, Uu, WwbY, WwbY, WwbY, Uu, Uh, Dbyu, Dbyu, Dbyu, Dbyu, Uh, Uh, Rb^Fdyu, Rb^Fdyu, Dbyu, Uh, Qxua, Qxua, Qxua, Uh, Dbyu, Dbyu^Es, Uh, Dbyu, Uh, Qxuz, Xsky, Xsky, Xsky^Zcla, Xsky
Uh, egDK, Urb, Urb^Cov, Urb, egDK, Uh, Dbyu, Dbyu, Dbyu, Uh, Uu, WwbY, WwbY, WobY, WwbY, WobY, WwbY, WwbY, Uu, Uh, Dbyu, Dbyu, Dbyu^XpY, Dbyu, Uh, Dbyu, Dbyu, Uh, Qxua, Qxua, Uh, Uu, Dbyu, Dbyu, Dbyu, Uh^Cov, Uh^Cov, Uh^Cov, Qxuz, Qxuz, Xsky, Xsky
Uh, egDC, Urb, 2 egDK, Urb, egDC, Uh, Dbyu, Dbyu, Uh, Uu, WwbY, WobY, WobY, Uh, Uh, Uh, WobY, WobY, WwbY, Uu, Uh, Dbyu, Dbyu, Dbyu, Dbyu^XpY, Dbyu, Dbyu, Dbyu, Uh, Uh, Uh, Dbyu, Dbyu, Dbyu, Uh, Uh^Cov, 1 Cud^Kov, Uh^Cov, Uh, Qxuz, Xsky, Xsky
Uh, egDK, egDC, Urb^Cov, egDC, egDK, Uh, Dbyu, Dbyu, Uh, Uh, WwbY, WwbY, WobY, WobY, Uu, WobY, WobY, WwbY, WwbY, Uh, Uh, Dbyu, Dbyu, Dbyu, Dbyu, Rb^Fdyu, Dbyu, Dbyu^XpY, Dbyu, Dbyu, Dbyu, Dbyu, Dbyu^XpY, Dbyu, Dbyu, Dbyu, Uh^Cov, Qxuz, Qxuz, Xsky, Xsky, Xsky
Dbyu, Uh, Uh, Urb, Uh, Uh, Dbyu, Dbyu^XpY, Dbyu, Dbyu, Dbyu, Uu, Uh, WwbY, WwbY, WwbY, WwbY, WwbY, Uh, Uu, Dbyu, Dbyu, Dbyu, Dbyu^XpY, Dbyu, Rb^Fdyu, Dbyu, Dbyu, Dbyu, Dbyu, Rb^Fdyu, Dbyu, Uu^Vu, Dbyu, Rb^Fdyu, Dbyu, Dbyu, Uh, Qxuz, Xsky, Xsky, Xsky^Zcla, Xsky
Dbyu, Dbyu, Dbyu, egDC, Dbyu, Dbyu, Dbyu, Dbyu, Dbyu, Dbyu^XpY, Dbyu^XpY, Dbyu, Dbyu, Uu, Uh, WwbY, Uh, Uu, Dbyu, Dbyu, Dbyu, Dbyu, Dbyu, Dbyu^XpY, Dbyu, Dbyu, Uu, Dbyu, Dbyu, Dbyu, Dbyu, Dbyu, Dbyu, Dbyu, Rb^Fdyu, Rb^Fdyu, Uh, Uh, Qxuz, Xsky, Xsky, Xsky, Xsky
Dbyu, Dbyu^XpY, Dbyu, Dbyu, Dbyu, Dbyu, Rb^Fdyu, Rb^Fdyu, Dbyu, Dbyu^XpY, Dbyu, Dbyu, Uu, Dbyu, Dbyu, Uh, Dbyu, Dbyu, Dbyu, Dbyu^XpY, Dbyu, Rb^Fdyu, Dbyu, Dbyu, Uh, Uh, Qxua, Uu, Dbyu, Dbyu, Dbyu^XpY, Dbyu^XpY, Dbyu^XpY, Dbyu, Rb^Fdyu, Rb^Fdyu, Uh, Uh, Qxuz, Xsky, Xsky, Xsky, Xsky
Dbyu, Dbyu, Rb^Fdyu, Dbyu, Dbyu, Dbyu, Dbyu, Rb^Fdyu, Dbyu, Dbyu, Uh, Uh, Qxua, Uu^Es, Uu, Dbyu, Dbyu^XpY, Dbyu, Uu^Es, Dbyu, Uu, Dbyu, Dbyu, Dbyu, Uh, Qxua, Qxua, Uh, Uu, Dbyu, Dbyu, Dbyu, Dbyu^XpY, Dbyu, Dbyu, Rb^Fdyu, Dbyu, Uh, Qxuz, Xsky, Xsky, Xsky, Xsky
Dbyu, Dbyu, Dbyu, Dbyu, Dbyu, Uu^Vu, Dbyu^XpY, Dbyu^XpY, Dbyu, Dbyu, Uh, Qxua, Qxua, Qxua, Uu, Dbyu, Dbyu, Dbyu, Uh, Uh, Uh, Dbyu, Rb^Fdyu, Rb^Fdyu, Dbyu, Uh, Uh, Uh, Uu^Vu, Rb^Fdyu, Dbyu, Dbyu^XpY, Dbyu, Dbyu, Uh, Dbyu, Dbyu, Uh, Qxuz, Xsky, Xsky, Xsky, Xsky
Dbyu, Dbyu, Dbyu, Dbyu^XpY, Dbyu, Dbyu, Dbyu, Dbyu^XpY, Dbyu^Es, Uu, Uh, Uu^Vu, Qxua, Qxua, Rb^Fdyu, Rb^Fdyu, Dbyu, Uu^Es, Uh, Uu^Vu, Uh, Dbyu^XpY, Dbyu, Rb^Fdyu, Dbyu, Dbyu, Dbyu, Dbyu, Dbyu, Dbyu, Dbyu^XpY, Dbyu, Dbyu, Uu, Uh, Uh, Uh, Uh, Qxuz, Xsky, Xsky, Xsky, Xsky
Dbyu, Dbyu, Dbyu, Dbyu, Rb^Fdyu, Rb^Fdyu, Rb^Fdyu, Dbyu, Uu, Uh, Uu, Uh, Uu, Rb^Fdyu, Rb^Fdyu, Rb^Fdyu, Rb^Fdyu, Dbyu^Es, Uh, Uh, Uh, Uh, Dbyu, Dbyu, Dbyu^XpY, Dbyu, Uh, Uh, Rb^Fdyu, Dbyu, Dbyu, Dbyu, Dbyu, Uu, Uh, Uh, Dbyu, Uh, Qxuz, Xsky, Xsky, Xsky, Xsky
Uh, Uu, Uh, Dbyu, Dbyu, Rb^Fdyu, Dbyu, Dbyu, Dbyu, Uh, Uh, Uh, Dbyu, Dbyu, Dbyu, Dbyu, Rb^Fdyu, Dbyu, Dbyu, Uu, Dbyu, Uu, Dbyu^XpY, Dbyu^XpY, Dbyu^XpY, Uu, Uh, Rb^Fdyu, Rb^Fdyu, Rb^Fdyu, Dbyu, Dbyu, Rb^Fdyu, Dbyu, Dbyu, Dbyu, Dbyu, Uh, Qxuz, Xsky, Xsky, Xsky, Xsky
Uh, Uh, Uh, Uu, Dbyu, Dbyu, Dbyu^XpY, Dbyu^XpY, Dbyu, Uu, Dbyu, Uu, Dbyu, Dbyu^XpY, Dbyu^XpY, Dbyu, Dbyu, Dbyu^XpY, Dbyu, Dbyu, Dbyu, Dbyu, Dbyu, Dbyu^XpY, Dbyu, Dbyu, Dbyu, Uh, Dbyu, Dbyu, Dbyu, Dbyu, Dbyu, Dbyu, Dbyu^XpY, Dbyu, Dbyu, Dbyu, Qxuz, Xsky, Xsky, Xsky, Xsky
Uh, Uh, Uh, Uh, Uu, Dbyu, Dbyu, Dbyu, Dbyu, Dbyu, Dbyu, Dbyu, Dbyu, Dbyu, Dbyu, Dbyu, Dbyu, Dbyu, Dbyu, Dbyu, Dbyu, Dbyu, Dbyu, Dbyu, Dbyu, Dbyu, Dbyu, Dbyu, Dbyu, Dbyu, Dbyu, Dbyu, Dbyu, Dbyu, Dbyu, Dbyu, Dbyu, Dbyu, Qxuz, Xsky, Xsky, Xsky, Xsky
