border_size=1
usage=map

Gs^Fds, Gs^Fds, Gs^Fds, Gs^Fds, Gs^Fds, Gs^Fds, Gs^Fds, Gs^Fds, Gs^Fds, Gs^Fds, Gs^Fds, Hh, Hh, Xu, Xu, Xu, Xu, Xu, Xu, Xu, Xu, Xu, Xu, Xu, Xu, Xu, Xu, Xu, Xu, Xu, Xu, Xu, Xu, Xu, Xu, Hh, Gs^Fds, Gs^Fds, Gs^Fds, Gs^Fds, Gs^Fds, Gs^Fds, Gs^Fds, Gs^Fds, Gs^Fds, Gs^Fds, Gs^Fds, Gs^Fds, Gs^Fds, Gs^Fds, Gs^Fds, Gs^Fds, Gs^Fds, Gs^Fds, Gs^Fds, Gs^Fds, Gs^Fds
Gs^Fds, Gs^Fds, Gs^Fds, Gs^Fds, Gs^Fds, Gs^Fds, Gs^Fds, Gs^Fds, Gs^Fds, Gs^Fds, Gs^Fds, Gs^Fds, Rb^Es, Hh, Xu, Xu, Xu, Xu, Uh^Dr, Uh, Uh, Xu, Xu, Xu, Xu, Xu, Xu, Xu, Xu, Xu, Xu, Xu, Xu, Xu, Xu, Hh, Rb^Es, Gs^Fds, Gs^Fds, Gs^Fds, Gs^Fds, Gs^Fds, Gs^Fds, Gs^Fds, Gs^Fds, Gs^Fds, Gs^Fds, Gs^Fds, Gs^Fds, Gs^Fds, Gd, Gs^Fds, Gs^Fds, Gs^Fds, Gs^Fds, Gs^Fds, Gs^Fds
Gs^Fds, Gs^Fds, Gll^Fp, Gs^Fds, Gll^Fp, Gs^Fds, Gs^Fds, Gs^Fds, Gs^Fds, Gs^Fds, Gs^Fds, Gs^Fds, Hh, Hh, Xu, Xu, Xu, Xu, Uu^Es, Qxu, Uu, Xu, Xu, Xu, Uu, Uh, Uu, Xu, Uh, Xu, Xu, Xu, Xu, Xu, Hh^Es, Hh, Gs^Fds, Gs^Fds, Gs^Fds, Gs^Fds, Gs^Fds, Gs^Fds, Gs^Fds, Gs^Fds, Gll^Fp, Gll^Fp, Gll^Fp, Gs^Fds, Gs^Fds, Re, Chr^Dr, Gd^Fetd, Rb^Es, Gs^Fds, Gg^Fet, Gs^Fds, Gs^Fds
Gs^Fds, Gs^Fds, Gs^Fds, Gs^Fds, Gll^Fp, Gll^Fp, Gs^Fds, Gs^Fds, Gll^Fp, Gll^Fp, Gs^Fds, Re^Dr, Hh^Dr, Xu, Xu, Xu, Xu, Xu, Xu, 2 Uu, Xu, Xu, Xu, Uu, Xu, Xu, Xu, Uu, Ur^Dr, Uh, Xu, Xu, Xu, Hh, Re^Es, Gs^Fds, Gs^Fds, Gs^Fds, Gs^Fds, Gll^Fp, Gll^Fp, Gs^Fds, Gs^Fds, Gs^Fds, Gll^Fp, Gd^Fetd, Gll^Fp, Gs^Fds, Gs^Fds, Re^Dr, Rd^Es, Khr, Re^Es, Gs^Fds, Gs^Fds, Gs^Fds, Gs^Fds
Gs^Fds, Gs^Fds, Gs^Fds, Gs^Fds, Gll^Fp, Gs^Fds, Gll^Fp, Gs^Fds, Gs^Fds, Gll^Fp, Re, Hh^Dr, Xu, Hh^Dr, Xu, Xu, Xu, Xu, Xu, Ur, Uu, Xu, Uu, Uu^Es, Xu, Xu, Uh, Uu^Ii, Qxu, Uh, Uh, Xu, Xu, Hh^Dr, Hh, Gs^Fds, Gs^Fds, Gs^Fds, Gll^Fp, Gll^Fp, Gll^Fp, Gs^Fds, Gs^Fds, Gll^Fp, Gll^Fp, Gll^Fp, Gll^Fp, Gs^Fds, Gs^Fds, Gll^Fp, Gs^Fds, Gs^Fds, Gs^Fds, Gs^Fds, Gs^Fds, Gll^Fp, Gs^Fds
Gs^Fds, Gs^Fds, Gll^Fp, Gll^Fp, Gs^Fds, Gll^Fp, Gs^Fds, Gs^Fds, Gs^Fds, Re^Es, Hh, Hh, Xu, Xu, Xu, Xu, Xu, Xu, Xu, Xu, Uu, Uu, Uh, Ur, Uu, Xu, Uu^Ii, Qxu, Qxu, Qxu, Uh, Xu, Xu, Xu, Hh^Es, Gs^Fds, Gs^Fds, Gs^Fds, Gs^Fds, Gll^Fp, Gs^Fds, Gs^Fds, Gs^Fds, Gll^Fp, Gs^Fds, Gs^Fds, Gs^Fds, Gs^Fds, Gs^Fds, Gs^Fds, Gs^Fds, Gg^Fet, Gs^Fds, Gs^Fds, Gs^Fds, Gs^Fds, Gs^Fds
Gs^Fds, Gs^Fds, Gs^Fds, Gs^Fds, Gs^Fds, Gs^Fds, Gll^Fp, Gs^Fds, Re, Hh, Xu, Xu, Xu, Xu, Xu, Xu, Xu, Xu, Xu, Uu, Uu, Uh, Uh, Uh^Ii, Uu^Dr, Uu, Uu, Uu^Es, Uu, Uu^Ii, Uh, Xu, Xu, Xu, Hh^Es, Hh, Gs^Fds, Gs^Fds, Gs^Fds, Gs^Fds, Gs^Fds, Gs^Fds, Gs^Fds, Gs^Fds, Gs^Fds, Gs^Fds, Gll^Fp, Gs^Fds, Gs^Fds, Gll^Fp, Gs^Fds, Gs^Fds, Gs^Fds, Gll^Fp, Gs^Fds, Gs^Fds, Gs^Fds
Gs^Fds, Gs^Fds, Gs^Fds, Gs^Fds, Re, Gs^Fds, Gs^Fds, Gs^Fds, Gg, Gd^Fetd, Xu, Xu, Uu^Uf, Xu, Xu, Xu, Xu, Xu, Xu, Xu, Uu^Es, Uu^Ii, Uh, Uu^Es, Uu, Uu^Ii, Xu, Xu, Xu, Xu, Xu, Xu, Xu, Hh^Es, Gs^Fds, Gs^Fds, Gs^Fds, Gs^Fds, Gll^Fp, Gs^Fds, Gs^Fds, Gs^Fds, Gll^Fp, Gll^Fp, Gs^Fds, Gs^Fds, Gs^Fds, Gs^Fds, Gs^Fds, Gs^Fds, Gs^Fds, Gs^Fds, Gs^Fds, Gs^Fds, Gll^Fp, Gs^Fds, Gs^Fds
Re, Re^Es, Rd, Re, Rb^Es, Re, Re, Rb, Re, Re^Es, Rb^Ii, Uu, Uu, Uh, Uu, Xu, Xu, Xu, Xu, Xu, Ur^Ii, Uu, Uu^Cov, Uu^Cov, Uu^Cov, Uh, Xu, Xu, Xu, Xu, Xu, Xu, Rb^Es, Gd^Fetd, Rd, Gs^Fds, Gs^Fds, Gs^Fds, Gs^Fds, Gs^Fds, Gs^Fds, Gll^Fp, Gs^Fds, Gll^Fp, Gs^Fds, Gs^Fds, Gs^Fds, Gs^Fds, Re, Gs^Fds, Gs^Fds, Gs^Fds, Gs, Gs^Fds, Gs^Fds, Gs^Fds, Gs^Fds
Gs^Fds, Gs^Fds, Gs^Fds, Re, Re, Re, Gs^Fds, Gs^Fds, Gg, Rd^Es, Rb^Ii, Ur, Uu, Ur^Ii, Uu, Ur, Ur, Ur^Es, Ur^Es, Ur, Ur^Es, Uu, Uu^Cov, Ur^Kov, Uu^Cov, Uu, Uu^Ii, Uu, Uu, Uu, Ur^Es, Ur, Rb, Re^Es, Rp, Gs^Fds, Gs^Fds, Gs^Fds, Re, Gs^Fds, Gg^Es, Gs^Fds, Rd, Gs^Fds, Gs^Fds, Gs^Fds, Gs^Fds, Rb, Gs, Re, Rd, 1 Gg, Gg, Gg^Efm, Re, Re^Es, Re
Gs^Fds, Gll^Fp, Gs^Fds, Gs^Fds, Gs^Fds, Gs^Fds, Gs^Fds, Gll^Fp, Re, Re^Es, Xu, Uu, Uu^Uf, Uu, Xu, Xu, Xu, Xu, Xu, Xu, Uu^Dr, Uu, Uh, Uu^Cov, Uu, Uu, Xu, Xu, Xu, Xu, Xu, Xu, Xu, Gd^Fetd, Gs^Fds, Re, Re^Es, Rp, Gs^Fds, Rb, Rb, Re, Gs^Fds, Re, Rp, Gs^Fds, Re, Re^Es, Gll^Fp, Gs^Fds, Gs^Fds, Gg, Gg, Gs, Gs^Fds, Gs^Fds, Gs^Fds
Gs^Fds, Gs^Fds, Gs^Fds, Gs^Fds, Gs^Fds, Gs^Fds, Gs^Fds, Gs^Fds, Gs^Fds, Gd^Fetd, Xu, Xu, Xu, Xu, Xu, Xu, Xu, Xu, Xu, Xu, Uu, Uu^Ii, Uh, Uu, Uu, Uh, Xu, Xu, Xu, Xu, Xu, Xu, Hh^Es, Hh, Gs^Fds, Gs^Fds, Gs^Fds, Gs^Fds, Gs^Fds, Gs^Fds, Gs^Fds, Gs^Fds, Gg^Fet, Gs^Fds, Gs^Fds, Rb, Gll^Fp, Gs^Fds, Gll^Fp, Gs^Fds, Gs^Fds, Gs^Fds, Gs^Fds, Gs^Fds, Gs^Fds, Gs^Fds, Gs^Fds
Gs^Fds, Gs^Fds, Gll^Fp, Gll^Fp, Gs^Fds, Gll^Fp, Gs^Fds, Gs^Fds, Gs^Fds, Hh, Hh, Xu, Xu, Xu, Xu, Xu, Xu, Xu, Xu, Uh, Uu^Es, Uh, Uh, Uh, Ur, Xu, Xu, Xu, Xu, Xu, Xu, Xu, Hh^Es, Rb^Es, Gs^Fds, Gs^Fds, Gs^Fds, Gs^Fds, Gs^Fds, Gs^Fds, Gs^Fds, Gs^Fds, Gs^Fds, Gs^Fds, Gs^Fds, Gs^Fds, Gs^Fds, Gll^Fp, Gll^Fp, Gll^Fp, Gs^Fds, Gs^Fds, Gs^Fds, Gs^Fds, Gs^Fds, Gll^Fp, Gs^Fds
Gs^Fds, Gs^Fds, Gs^Fds, Gll^Fp, Gs^Fds, Gs^Fds, Gs^Fds, Gll^Fp, Gs^Fds, Re^Es, Hh, Xu, Xu, Xu, Xu, Xu, Xu, Xu, Xu, Xu, Xu, Uu, Uu, Uu, Xu, Xu, Uu^Dr, 3 Uh, Xu, Xu, Xu, Xu, Xu, Hh, Gs^Fds, Gs^Fds, Gll^Fp, Gs^Fds, Gs^Fds, Gll^Fp, Gll^Fp, Gs^Fds, Gll^Fp, Gs^Fds, Gs^Fds, Gs^Fds, Gs^Fds, Gll^Fp, Gs^Fds, Gs^Fds, Gs^Fds, Gs^Fds, Gs^Fds, Gs^Fds, Gs^Fds, Gs^Fds, Gs^Fds
Gs^Fds, Gs^Fds, Gs^Fds, Gs^Fds, Gll^Fp, Gs^Fds, Gs^Fds, Gs^Fds, Gs^Fds, Re^Es, Re^Es, Hh, Hh, Hh^Dr, Xu, Xu, Xu, Xu, Xu, Xu, Ur, Ur^Dr, Uh, Uh, Xu, Uh, Uu, Uu, Uu, Xu, Xu, Xu, Xu, Hh, Gs^Fds, Gs^Fds, Gs^Fds, Gs^Fds, Gs^Fds, Gll^Fp, Gs^Fds, Gs^Fds, Gll^Fp, Gs^Fds, Gll^Fp, Gs^Fds, Gs^Fds, Gs^Fds, Gs^Fds, Gs^Fds, Gs^Fds, Gll^Fp, Gs^Fds, Gs^Fds, Gll^Fp, Gs^Fds, Gs^Fds
Gs^Fds, Gs^Fds, Gs^Fds, Gs^Fds, Gs^Fds, Gs^Fds, Gs^Fds, Gs^Fds, Gs^Fds, Gs^Fds, Gll^Fp, Re^Es, Rb^Es, Hh, Xu, Xu, Xu, Xu, Xu, Xu, Ur, Xu, Xu, Xu, Uh^Dr, Xu, Uu^Es, Ur, Uu, Xu, Xu, Xu, Hh^Dr, Hh^Es, Re^Es, Gs^Fds, Gs^Fds, Gs^Fds, Gs^Fds, Gll^Fp, Re^Es, Re^Es, Rd^Ii, Gs^Fds, Gs^Fds, Gs^Fds, Gs^Fds, Gs^Fds, Gll^Fp, Gs^Fds, Gs^Fds, Gs^Fds, Gs^Fds, Gs^Fds, Gs^Fds, Gs^Fds, Gs^Fds
Gs^Fds, Gs^Fds, Gll^Fp, Gs^Fds, Gs^Fds, Gs^Fds, Gll^Fp, Gs^Fds, Gs^Fds, Gs^Fds, Gs^Fds, Gs^Fds, Re^Es, Hh^Es, Xu, Xu, Xu, Xu, Xu, Xu, Xu, Ur^Es, Ur, Ur, Ur^Es, Xu, Uu^Es, Uu, Uh, Xu, Xu, Xu, Hh^Dr, Rd^Dr, Re^Es, Gs^Fds, Gs^Fds, Gs^Fds, Gll^Fp, Gs^Fds, Gd^Es, Gll^Ima, Re^Es, Gs^Fds, Gs^Fds, Gll^Fp, Gs^Fds, Gs^Fds, Gll^Fp, Gll^Fp, Gll^Fp, Gs^Fds, Gg^Fet, Gll^Fp, Gs^Fds, Gs^Fds, Gs^Fds
Gs^Fds, Gs^Fds, Gs^Fds, Gll^Fp, Gll^Fp, Gs^Fds, Gll^Fp, Gll^Fp, Gll^Fp, Gs^Fds, Gs^Fds, Gs^Fds, Re, Hh, Xu, Xu, Xu, Xu, Xu, Xu, Xu, Xu, Xu, Xu, Xu, Ur, Xu, Uh, Xu, Xu, Xu, Xu, Xu, Hh^Es, Hh, Re^Es, Gs^Fds, Gs^Fds, Gs^Fds, Re^Es, Gs^Fds, Gll^Es, Gs^Fds, Gs^Fds, Gs^Fds, Gs^Fds, Gs^Fds, Gll^Fp, Gll^Fp, Gll^Fp, Gll^Fp, Gs^Fds, Gs^Fds, Gs^Fds, Gs^Fds, Gll^Fp, Gs^Fds
Gs^Fds, Gs^Fds, Gs^Fds, Gs^Fds, Gs^Fds, Gs^Fds, Gs^Fds, Gs^Fds, Gs^Fds, Gs^Fds, Gs^Fds, Gs^Fds, Gs^Fds, Hh, Xu, Xu, Xu, Xu, Xu, Xu, Xu, Xu, Xu, Xu, Xu, Xu, Xu, Xu, Xu, Xu, Xu, Xu, Xu, Xu, Hh, Gs^Fds, Gs^Fds, Gs^Fds, Gs^Fds, Gs^Fds, Gs^Fds, Gs^Fds, Gs^Fds, Gs^Fds, Gs^Fds, Gs^Fds, Gs^Fds, Gs^Fds, Gs^Fds, Gll^Fp, Gs^Fds, Gs^Fds, Gs^Fds, Gs^Fds, Gs^Fds, Gs^Fds, Gs^Fds
