border_size=1
usage=map

Qxua, Qxua, Qxua, Qxua, Qxua, Qxua, Qxua, Qxua, Qxua, Qxua, Qxua, Qxua, Qxua, Qxua, Qxua, Qxua, Qxua, Qxua, Qxua, Qxua, Qxua, Qxua, Qxua, Qxua, Qxua
Qxua, Qxua, Qxua, Qxua, Qxua, Qxua, Qxua, Qxua, Qxua, Qxua, Qxua, Qxua, Qxua, Qxua, Qxua, Qxua, Qxua, Qxua, Qxua, Qxua, Qxua, Qxua, Qxua, Qxua, Qxua
Qxua, Qxua, Qxua, Qxua, Dbyu, Dbyu, Dbyu, Dbyu, Dbyu, Dbyu, Dbyu, Dbyu, Dbyu, Dbyu, Dbyu, Dbyu, Dbyu, Dbyu, Dbyu, Dbyu, Dbyu, Qxua, Qxua, Qxua, Qxua
Qxua, Qxua, Dbyu, Dbyu, Dbyu, Dbyu, Uh, Uh, Uh, Dbyu, Dbyu, Dbyu, Uu, Dbyu, Dbyu, Dbyu, Uh, Uh, Uh, Dbyu, Dbyu, Dbyu, Dbyu, Qxua, Qxua
Qxua, Qxua, Dbyu, Dbyu, Dbyu, Dbyu, Uh, Uh, Dbyu, Dbyu, Uu, Uu, Cud, Uu, Uu, Dbyu, Dbyu, Uh, Uh, Dbyu, Dbyu, Dbyu, Dbyu, Qxua, Qxua
Qxua, Qxua, Dbyu, Dbyu, Dbyu, Dbyu, Dbyu, Dbyu, Uu, Uu, Uh, Uh, Dbyu^Xo, Uh, Uh, Uu, Uu, Dbyu, Dbyu, Dbyu, Dbyu, Dbyu, Dbyu, Qxua, Qxua
Qxua, Qxua, Dbyu, Dbyu, Cud, Dbyu, Uu, Uu, Uh, Uh, Dbyu^Xo, Dbyu^Xo, Urb, Dbyu^Xo, Dbyu^Xo, Uh, Uh, Uu, Uu, Dbyu, Cud, Dbyu, Dbyu, Qxua, Qxua
Qxua, Qxua, Dbyu, Dbyu, Dbyu, Uu, Qxua, Qxua, Uh, Dbyu^Xo, Urb, Urb, Uh, Urb, Urb, Dbyu^Xo, Uh, Qxua, Qxua, Uu, Dbyu, Dbyu, Dbyu, Qxua, Qxua
Qxua, Qxua, Dbyu, Dbyu, Uh, Uu, Qxua, Qxua, 2 Cud, Dbyu^Xo, Urb, Uh, 1 WYwb, Uh, Urb, Dbyu^Xo, Cud, Qxua, Qxua, Uu, Uh, Dbyu, Dbyu, Qxua, Qxua
Qxua, Qxua, Dbyu, Dbyu, Dbyu, Uu, Qxua, Qxua, Uh, Dbyu^Xo, Urb, Uh, Uh, Uh, Urb, Dbyu^Xo, Uh, Qxua, Qxua, Uu, Dbyu, Dbyu, Dbyu, Qxua, Qxua
Qxua, Qxua, Dbyu, Dbyu, Cud, Uu, Uu, Qxua, Uh, Dbyu^Xo, Dbyu^Xo, Urb, Urb, Urb, Dbyu^Xo, Dbyu^Xo, Uh, Qxua, Uu, Uu, Cud, Dbyu, Dbyu, Qxua, Qxua
Qxua, Qxua, Dbyu, Dbyu, Dbyu, Dbyu, Dbyu, Uu, Uu, Uh, Uh, Dbyu^Xo, Dbyu^Xo, Dbyu^Xo, Uh, Uh, Uu, Uu, Dbyu, Dbyu, Dbyu, Dbyu, Dbyu, Qxua, Qxua
Qxua, Qxua, Dbyu, Dbyu, Dbyu, Dbyu, Uh, Dbyu, Dbyu, Uu, Uu, Uh, Cud, Uh, Uu, Uu, Dbyu, Dbyu, Uh, Dbyu, Dbyu, Dbyu, Dbyu, Qxua, Qxua
Qxua, Qxua, Dbyu, Dbyu, Dbyu, Dbyu, Uh, Uh, Uh, Dbyu, Dbyu, Uu, Uu, Uu, Dbyu, Dbyu, Uh, Uh, Uh, Dbyu, Dbyu, Dbyu, Dbyu, Qxua, Qxua
Qxua, Qxua, Qxua, Dbyu, Dbyu, Dbyu, Dbyu, Uh, Dbyu, Dbyu, Dbyu, Dbyu, Dbyu, Dbyu, Dbyu, Dbyu, Dbyu, Uh, Dbyu, Dbyu, Dbyu, Dbyu, Qxua, Qxua, Qxua
Qxua, Qxua, Qxua, Qxua, Qxua, Dbyu, Qxua, Dbyu, Qxua, Dbyu, Qxua, Dbyu, Qxua, Dbyu, Qxua, Dbyu, Qxua, Dbyu, Qxua, Dbyu, Qxua, Qxua, Qxua, Qxua, Qxua
Qxua, Qxua, Qxua, Qxua, Qxua, Qxua, Qxua, Qxua, Qxua, Qxua, Qxua, Qxua, Qxua, Qxua, Qxua, Qxua, Qxua, Qxua, Qxua, Qxua, Qxua, Qxua, Qxua, Qxua, Qxua
