border_size=1
usage=map

Dbyu, Dbyu, Dbyu, Uh, Qxuz, Xsky, Xsky, Xsky, Xsky, Xsky, Xsky, Xsky, Xsky, Xsky, Xsky, Xsky, Xsky, Xsky, Xsky, Xsky, Xsky, Xsky, Xsky, Xsky, Xsky, Xsky, Xsky, Xsky, Xsky, Xsky, Xsky, Xsky, Xsky, Xsky, Xsky, Xsky, Xsky, Xsky, Xsky, Xsky, Xsky, Qxuz, Uh, AYb, AYb, AYb, UYi, UYi, UYi
Rb^Fdyu, Dbyu, Dbyu, Uh, Qxuz, Xsky, Xsky, Xsky, Xsky, Xsky, Xsky, Xsky, Xsky, Xsky, Xsky, Xsky, Xsky, Xsky, Xsky, Xsky, Xsky, Xsky, Xsky, Xsky, Xsky, Xsky, Xsky, Xsky, Xsky, Xsky, Xsky, Xsky, Xsky, Xsky, Xsky, Xsky, Xsky, Xsky, Xsky, Xsky, Xsky, Qxuz, Uh, UYi, UYi, UYi, UYi, UYi, UYi
Rb^Fdyu, Rb^Fdyu, Dbyu, Uh, Qxuz, Xsky, Xsky, Xsky, Xsky, Xsky, Xsky, Xsky, Xsky, Xsky, Xsky, Xsky, Xsky, Xsky, Xsky, Xsky, Xsky, Xsky, Xsky, Xsky, Xsky, Xsky, Xsky, Xsky, Xsky, Xsky, Xsky, Xsky, Xsky, Xsky, Xsky, Xsky, Xsky, Xsky, Xsky, Xsky, Xsky, Qxuz, Uh, AYb, AYb, UYi, UYi, UYi, AYb
Dbyu, Dbyu, Uh, Uh, Qxuz, Xsky, Xsky, Xsky, Xsky, Xsky, Xsky, Xsky, Xsky, Xsky, Xsky, Xsky, Xsky^ZclW, Xsky, Xsky, Xsky, Xsky^ZclW, Xsky^ZclW, Xsky^ZclW, Xsky, Xsky^ZclW, Xsky, Xsky^ZclW, Xsky, Xsky, Xsky, Xsky, Xsky, Xsky, Xsky, Xsky, Xsky, Xsky, Xsky, Xsky, Xsky, Xsky, Qxuz, Uh, AYb, AYb, UYi, AYb, AYb, AYb
Dbyu, Uh, Uh, Uh, Qxuz, Xsky, Xsky, Xsky, Xsky, Xsky, Xsky, Xsky, Xsky^ZclW, Xsky^ZclW, Xsky^ZclW, Xsky^ZclW, Xsky^ZclW, Xsky^ZclW, Xsky^ZclW, Xsky^ZclW, Xsky, Xsky^ZclW, Xsky, Xsky^ZclW, Xsky, Xsky^ZclW, Xsky, Xsky^ZclW, Xsky^ZclW, Xsky, Xsky^ZclW, Xsky, Xsky, Xsky, Xsky, Xsky, Xsky, Xsky, Xsky, Xsky, Xsky, Qxuz, Uh, AYb, UYi, UYi, UYi, AYb, UYi
Uh, Dbyu, Dbyu, Uh, Qxuz, Xsky, Xsky, Xsky, Xsky, Xsky, Xsky^ZclW, Xsky^ZclW, Xsky, Xsky^ZclW, Xsky, Xsky, Xsky, Xsky, Xsky, Xsky, Xsky, Xsky, Xsky, Xsky, Xsky, Xsky, Xsky, Xsky, Xsky, Xsky^ZclW, Xsky^ZclW, Xsky^ZclW, Xsky^ZclW, Xsky, Xsky, Xsky, Xsky, Xsky, Xsky, Xsky, Xsky, Qxuz, Uh, UYi, UYi, AYb, AYb, UYi, UYi
Uh, Uh, Dbyu, Uh, Qxuz, Xsky, Xsky, Xsky, Xsky^ZclW, Xsky^ZclW, Xsky, Xsky, Xsky, Xsky, Xsky, Xsky, Xsky, Xsky, Xsky, Xsky, Xsky, Xsky, Xsky, Xsky, Xsky, Xsky, Xsky, Xsky, Xsky, Xsky, Xsky, Xsky, Xsky, Xsky^ZclW, Xsky^ZclW, Xsky, Xsky, Xsky, Xsky, Xsky, Qxuz, Qxuz, Uh, AYb, UYi, UYi, AYb, UYi, UYi
Dbyu, Uh, Dbyu, Uh, Qxuz, Xsky, Xsky^ZclW, Xsky^ZclW, Xsky, Xsky, Xsky, Xsky, Xsky, Xsky, Xsky, Xsky, Xsky, Xsky, Qxua^RfUw, Xsky, Qxua^RfUw, Xsky, Xsky, Xsky, Xsky, Xsky, Xsky, Xsky, Xsky, Xsky, Xsky, Xsky, Xsky, Xsky, Xsky, Xsky^ZclW, Xsky^ZclW, Xsky, Qxuz, Qxuz, Uh, Uh, UYi, AYb, UYi, AYb, UYi, UYi, AYb
Dbyu, Dbyu, Uh, Uh, Uh, Qxuz^ZclW, Qxuz, Xsky, Xsky, Xsky, Xsky, Xsky, Xsky, Xsky, Xsky, Xsky, Xsky, Xsky, Qxua^RfUw, Qxua^Cov, Qxua^RfUw, Qxua^RfUw, Xsky, Xsky, Xsky, Xsky, Xsky, Xsky, Xsky, Xsky, Xsky, Xsky, Xsky, Xsky, Xsky, Xsky, Xsky, Qxuz^ZclW, Uh^Xo, Uh, 1 UYi, AYb, AYb, UYi, UYi, UYi, AYb, AYb, AYb
Dbyu, Uh, Uh, Cud, Uh, Uh, Qxuz, Xsky, Xsky, Xsky, Xsky, Xsky, Xsky, Xsky, Xsky, Xsky, Xsky, Qxua^RfUw, Qxua^RfUw, 2 Qxua^Kov, Qxua^RfUw, Xsky, Xsky, Xsky, Xsky, Xsky, Xsky, Xsky, Xsmy, Xsky, Xsky, Xsky, Xsky, Xsky, Xsky, Xsky, Xsky^ZclW, Qxuz^ZclW, Qxuz, Uh, Uh, AYb, UYi, UYi, UYi, UYi, AYb, AYb, AYb
Dbyu, Dbyu, Dbyu, Uh, Qxuz, Qxuz^ZclW, Xsky^ZclW, Xsky, Xsky, Xsky, Xsky, Xsky, Xsky, Xsky, Xsky, Xsky, Xsky, Xsky, Qxua^RfUw, Qxua^Cov, Qxua^RfUw, Qxua^RfUw, Xsky, Xsky, Xsky, Xsky, Xsky, Xsky, Xsky, Xsky, Xsky, Xsky, Xsky, Xsky, Xsky^ZclW, Xsky^ZclW, Xsky, Xsky, Xsky, Qxuz, Qxuz, Uh, Uh, AYb, AYb, UYi, UYi, AYb, UYi
Rb^Fdyu, Dbyu, Dbyu, Uh, Qxuz, Xsky, Xsky, Xsky^ZclW, Xsky^ZclW, Xsky, Xsky, Xsky, Xsky, Xsky, Xsky, Xsky, Xsky, Xsky, Xsky, Xsky, Xsky, Xsky, Xsky, Xsky, Xsky, Xsky, Xsky, Xsky, Xsky, Xsky, Xsky^ZclW, Xsky^ZclW, Xsky^ZclW, Xsky^ZclW, Xsky, Xsky, Xsky, Xsky, Xsky, Xsky, Xsky, Qxuz, Uh, AYb, AYb, AYb, UYi, UYi, AYb
Rb^Fdyu, Rb^Fdyu, Uh, Uh, Qxuz, Xsky, Xsky, Xsky, Xsky, Xsky^ZclW, Xsky^ZclW, Xsky, Xsky^ZclW, Xsky, Xsky, Xsky, Xsky, Xsky, Xsky, Xsky, Xsky, Xsky, Xsky, Xsky, Xsky, Xsky, Xsky, Xsky, Xsky, Xsky, Xsky^ZclW, Xsky^ZclW, Xsky, Xsky, Xsky, Xsky, Xsky, Xsky, Xsky, Xsky, Xsky, Qxuz, Uh, AYb, AYb, UYi, UYi, UYi, UYi
Rb^Fdyu, Rb^Fdyu, Uh, Uh, Qxuz, Xsky, Xsky, Xsky, Xsky, Xsky, Xsky, Xsky^ZclW, Xsky^ZclW, Xsky^ZclW, Xsky^ZclW, Xsky, Xsky^ZclW, Xsky, Xsky, Xsky, Xsky, Xsky, Xsky, Xsky, Xsky, Xsky, Xsky, Xsky, Xsky^ZclW, Xsky^ZclW, Xsky^ZclW, Xsky^ZclW, Xsky, Xsky, Xsky, Xsky, Xsky, Xsky, Xsky, Xsky, Xsky, Qxuz, Uh, AYb, AYb, AYb, UYi, UYi, AYb
Dbyu, Rb^Fdyu, Dbyu, Uh, Qxuz, Xsky, Xsky, Xsky, Xsky, Xsky, Xsky, Xsky, Xsky, Xsky, Xsky, Xsky^ZclW, Xsky^ZclW, Xsky^ZclW, Xsky^ZclW, Xsky^ZclW, Xsky^ZclW, Xsky, Xsky^ZclW, Xsky, Xsky, Xsky, Xsky^ZclW, Xsky^ZclW, Xsky, Xsky, Xsky, Xsky, Xsky, Xsky, Xsky, Xsky, Xsky, Xsky, Xsky, Xsky, Xsky, Qxuz, Uh, UYi, UYi, UYi, UYi, AYb, AYb
Uh, Dbyu, Dbyu, Uh, Qxuz, Xsky, Xsky, Xsky, Xsky, Xsky, Xsky, Xsky, Xsky, Xsky, Xsky, Xsky, Xsky, Xsky, Xsky, Xsky, Xsky, Xsky^ZclW, Xsky, Xsky^ZclW, Xsky^ZclW, Xsky^ZclW, Xsky, Xsky, Xsky, Xsky, Xsky, Xsky, Xsky, Xsky, Xsky, Xsky, Xsky, Xsky, Xsky, Xsky, Xsky, Qxuz, Uh, AYb, AYb, AYb, UYi, UYi, UYi
Uh, Uh, Uh, Uh, Qxuz, Xsky, Xsky, Xsky, Xsky, Xsky, Xsky, Xsky, Xsky, Xsky, Xsky, Xsky, Xsky, Xsky, Xsky, Xsky, Xsky, Xsky, Xsky, Xsky, Xsky, Xsky, Xsky, Xsky, Xsky, Xsky, Xsky, Xsky, Xsky, Xsky, Xsky, Xsky, Xsky, Xsky, Xsky, Xsky, Xsky, Qxuz, Uh, AYb, AYb, AYb, AYb, UYi, UYi
Uh, Uh, Dbyu, Uh, Qxuz, Xsky, Xsky, Xsky, Xsky, Xsky, Xsky, Xsky, Xsky, Xsky, Xsky, Xsky, Xsky, Xsky, Xsky, Xsky, Xsky, Xsky, Xsky, Xsky, Xsky, Xsky, Xsky, Xsky, Xsky, Xsky, Xsky, Xsky, Xsky, Xsky, Xsky, Xsky, Xsky, Xsky, Xsky, Xsky, Xsky, Qxuz, Uh, AYb, UYi, UYi, UYi, UYi, AYb
Dbyu, Dbyu, Dbyu, Uh, Qxuz, Xsky, Xsky, Xsky, Xsky, Xsky, Xsky, Xsky, Xsky, Xsky, Xsky, Xsky, Xsky, Xsky, Xsky, Xsky, Xsky, Xsky, Xsky, Xsky, Xsky, Xsky, Xsky, Xsky, Xsky, Xsky, Xsky, Xsky, Xsky, Xsky, Xsky, Xsky, Xsky, Xsky, Xsky, Xsky, Xsky, Qxuz, Uh, UYi, AYb, AYb, AYb, UYi, UYi
